(supertux-level
  (version 3)
  (name (_ "Calm Coast Round"))
  (author "Sophie Ball")
  (license "CC-BY-SA 4.0 International")
  (allow-item-pocket "on")
  (icon "")
  (icon-locked "")
  (sector
    (name "main")
    (ambient-light
      (color 1 1 1)
    )
    (level
      (z-pos 50)
      (level "zone1.stl")
      (x 10)
      (y 26)
    )
    (level
      (z-pos 50)
      (level "zone2.stl")
      (x 12)
      (y 20)
    )
    (level
      (z-pos 50)
      (x 19)
      (y 17)
    )
    (music
      (file "/music/worldmap/starfish.music")
    )
    (teleporter
      (z-pos 50)
      (worldmap "/levels/round5/worldmap.stwm")
      (sector "main")
      (spawnpoint "back")
      (message (_ "Go to Volcanic Vacation Round?"))
      (x 10)
      (y 29)
    )
    (teleporter
      (z-pos 50)
      (message (_ "Go to Forest Fantasy Round 2?"))
      (x 22)
      (y 17)
    )
    (tilemap
      (solid #f)
      (z-pos -100)
      (width 100)
      (height 100)
      (tiles -10000 1)
    )
    (tilemap
      (solid #t)
      (z-pos 0)
      (width 100)
      (height 100)
      (tiles -1310 0 1050 -8 1051 1052 -88 0 1050 1051 1063 -8 1054 1062 -2 1051 1052 -84 0 1050 1063 -13 1054 1062 1052 -83 0 1053 -15 1054 1055 -83 0 1053 -15 1054 1055 -83 0 1053 -15 1054 1055 -83 0 1053 -14 1054 1059 1058 -82 0 1050 1063 -12 1054 1059 1057 1058 -83 0 1053 -12 1054 1059 1058 -84 0 1050 1063 -11 1054 1059 1058 -85 0 1053 1059 1057 1060 -9 1054 1055 -85 0 1050 1063 1062 1052 1056 1060 -7 1054 1059 1058 -85 0 1053 -2 1054 1062 1051 1063 -7 1054 1055 -86 0 1053 -6 1054 1059 1057 1060 -2 1054 1059 1058 -86 0 1053 -6 1054 1062 1051 1063 -2 1054 1055 -87 0 1056 1060 -9 1054 1059 1058 -88 0 1056 1060 -7 1054 1059 1058 -90 0 1056 -7 1057 1058 -6985 0)
    )
    (tilemap
      (solid #t)
      (z-pos 1)
      (width 100)
      (height 100)
      (tiles -1311 0 1065 1066 1065 1066 1065 1066 1065 1066 -92 0 1067 1068 1067 1068 1067 1068 1067 1068 -89 0 1065 1066 543 0 544 -2 0 473 -4 0 797 -87 0 1067 1068 0 471 -3 0 537 -2 538 539 -2 0 473 -85 0 1065 1066 356 1065 1066 423 -9 435 441 -84 0 1067 1068 0 1067 1068 436 -6 0 537 -2 538 539 -86 0 541 0 471 436 -2 0 544 -2 0 356 -87 0 1065 1066 356 544 1065 1066 436 -2 0 537 539 1065 1066 -87 0 1067 1068 -2 0 1067 1068 436 1065 1066 -2 0 1067 1068 -86 0 1065 1066 537 -3 538 539 436 1067 1068 0 543 -88 0 1067 1068 -5 0 436 0 473 537 538 539 -88 0 797 -3 0 423 435 426 544 0 1065 1066 -89 0 1065 1066 -2 0 436 -3 0 797 1067 1068 -89 0 1067 1068 472 0 436 -3 0 471 -90 0 356 537 539 1065 1066 436 -2 0 1065 1066 -92 0 797 1067 1068 436 0 356 1067 1068 -93 0 544 0 440 -2 0 544 -7086 0)
    )
    (tilemap
      (solid #f)
      (z-pos 100)
      (width 100)
      (height 100)
      (tiles -1421 0 1065 1066 -98 0 1067 1068 -191 0 1065 1066 1065 1066 -96 0 1067 1068 1067 1068 -593 0 1065 1066 -98 0 1067 1068 -7487 0)
    )
    (tilemap
      (solid #f)
      (z-pos 2)
      (width 100)
      (height 100)
      (tiles -1310 0 1065 1066 1065 1066 1065 1066 1065 1066 1065 1066 -90 0 1067 1068 1067 1068 1067 1068 1067 1068 1067 1068 -399 0 1065 1066 -98 0 1067 1068 -288 0 1065 1066 -98 0 1067 1068 -7689 0)
    )
    (tilemap
      (solid #f)
      (z-pos 101)
      (width 100)
      (height 100)
      (tiles -1522 0 1065 1066 -98 0 1067 1068 -189 0 1065 1066 1065 1066 -96 0 1067 1068 1067 1068 -8083 0)
    )
    (worldmap-spawnpoint
      (z-pos 50)
      (name "main")
      (x 10)
      (y 27)
    )
  )
  (tileset "images/ice_world.strf")
)
