(supertux-level
  (version 3)
  (name (_ "Boss Fight"))
  (author "Sophie Ball")
  (note (_ "You must have two big keys or you're NOT going there."))
  (license "CC-BY-SA 4.0 International")
  (allow-item-pocket "inherit")
  (icon "")
  (icon-locked "")
  (statistics
    (enable-coins #f)
    (enable-badguys #f)
    (enable-secrets #f)
  )
  (sector
    (name "main")
    (ambient-light
      (color 1 1 1)
    )
    (background
      (color 1 1 1)
      (alignment "bottom")
      (speed 0)
      (image "/images/background/antarctic/snow_panorama.png")
    )
    (background
      (color 1 1 1)
      (scroll-speed-x -10)
      (speed 0)
      (image "/images/background/misc/skybox.png")
      (z-pos -302)
    )
    (background
      (color 1 1 1)
      (alignment "bottom")
      (scroll-speed-x -5)
      (speed 0)
      (image "/images/background/misc/clouds.png")
      (z-pos -301)
    )
    (camera
      (name "Camera")
      (mode "normal")
    )
    (door
      (z-pos -99)
      (sector "bosscutscene")
      (locked #f)
      (spawnpoint "main")
      (x 928)
      (y 736)
    )
    (gradient
      (top_color 0.3 0.4 0.75)
      (bottom_color 1 1 1)
      (z-pos -303)
    )
    (infoblock
      (z-pos 51)
      (message (_ "A mysterious door... But there's also an invisible wall blocking you?
Maybe if you have 2 big keys, you could get to this door.
But remember this, if you go through that door, there's no coming back here until you defeat whatever that door leads to.

HINT 1: Good Future Backwards
HINT 2: Trampoline To Past"))
      (x 256)
      (y 704)
    )
    (music
      (file "/music/present/icyisland.music")
    )
    (particles-snow
    )
    (scripttrigger
      (script "if(state.world2_keys.air) {
    if( ! (\"airopen\" in this)) {
        a.fade(0, 0);
    }
} else {
    a.fade(1, 0);
}")
      (button #f)
      (width 32)
      (height 832)
      (x 640)
      (y 0)
    )
    (scripttrigger
      (script "if(state.world2_keys.earth) {
    if( ! (\"earthopen\" in this)) {
        b.fade(0, 0);
    }
} else {
    b.fade(1, 0);
}")
      (button #f)
      (width 32)
      (height 832)
      (x 768)
      (y 0)
    )
    (spawnpoint
      (name "main")
      (x 96)
      (y 768)
    )
    (tilemap
      (solid #f)
      (z-pos -100)
      (width 100)
      (height 35)
      (tiles -3500 0)
    )
    (tilemap
      (solid #f)
      (z-pos 100)
      (width 100)
      (height 35)
      (tiles -3500 0)
    )
    (tilemap
      (solid #t)
      (z-pos 0)
      (width 100)
      (height 35)
      (tiles -40 0 10 11 5369 -2 11 5368 -5 11 5368 11 -2 5369 11 -3 5368 -2 11 5368 11 5368 -5 11 -2 5369 11 -2 5369 5368 -4 11 5369 11 5369 -3 11 -2 5368 5369 -2 11 5368 11 5368 -3 11 5368 -3 11 -40 0 10 -2 11 -3 5369 -3 11 5369 -4 11 5368 -2 11 1539 -2 11 5368 11 5368 11 5368 11 5368 11 -2 5368 11 5368 -7 11 5368 -3 5369 5368 -3 11 5369 -3 5368 5369 -7 11 5369 -40 0 10 -2 11 5368 -2 11 5369 -2 11 -3 5369 11 5369 5368 5369 -3 11 5368 11 5369 11 5368 11 5368 11 5369 5368 -3 11 5368 -2 5369 11 5369 -3 11 5369 -2 11 5368 11 5368 -3 11 5368 -4 11 5369 -3 11 5369 11 -40 0 10 5368 11 5369 -6 11 5368 11 -2 5369 11 5369 5368 5369 -2 11 5369 5368 5369 5368 5369 11 5369 5368 -2 11 5369 -3 11 5368 -2 11 5369 5368 -2 11 5369 -4 11 5368 5369 -2 11 5369 -4 11 5368 -3 11 5369 -40 0 10 -5 11 5368 -3 11 -2 5369 -7 11 -2 5368 5369 5368 5369 5368 5369 5368 -2 11 5369 -2 11 5368 -3 11 5368 -2 11 5368 5369 -2 5368 -4 11 -3 5369 -2 11 5369 5368 11 5368 5369 -2 5368 5369 -40 0 10 11 5369 11 5368 11 5368 -4 11 5369 -4 11 5369 -3 11 5369 5368 5369 5368 -2 5369 -2 11 5368 -2 5369 11 5368 -2 11 5369 -4 11 5368 11 5369 11 5369 -2 11 5368 -5 11 5368 -3 11 5369 -2 5368 -40 0 10 5369 5368 -6 11 5369 -3 11 5368 -2 11 5368 -2 11 5368 11 5369 5368 11 5369 -2 11 5368 5369 -4 11 5368 5369 -2 11 5368 11 5369 -2 11 5368 -3 11 5368 -2 11 5369 5368 -2 11 5368 11 -2 5368 5369 -2 11 -40 0 10 -2 5368 5369 -2 11 5368 11 5369 5368 5369 11 5368 -3 11 5368 5369 -2 11 -2 5368 5369 5368 -3 11 5368 11 5368 5369 -4 11 5369 11 5369 -12 11 5369 -4 11 5369 -2 5368 11 5368 -40 0 10 5368 11 5368 11 5369 -2 5368 5369 11 5368 -2 11 5368 -7 11 5369 5368 11 5369 -9 11 5369 11 -3 5368 -2 11 5369 -2 11 5368 -2 11 5369 -2 5368 5369 11 5368 -2 11 5368 -3 11 5369 -40 0 10 11 -4 5369 -3 11 5369 5368 5369 -3 11 5368 11 1539 -4 11 -2 5369 -5 11 5368 11 5369 5368 -5 11 5368 -2 11 5369 -2 11 5369 11 5368 11 5369 -3 5368 -4 11 5368 -2 11 5369 -40 0 10 5368 5369 11 5368 11 5369 -2 5368 5369 -2 11 5369 11 -2 5368 5369 -2 5368 -2 11 5368 19 -2 11 5368 11 5369 -9 11 5369 -3 11 -4 5368 5369 -2 11 5368 -2 11 5369 -2 11 -3 5369 -3 11 -40 0 10 5368 -2 11 -2 5369 -2 11 5368 -3 11 5369 1539 5368 11 5369 11 -2 5368 -2 11 5368 5369 11 5368 11 5369 11 5369 11 5368 1539 11 5369 -6 11 5369 5368 -6 11 5368 11 -2 5368 5369 11 -2 5369 11 5369 11 -40 0 10 -4 11 5369 -4 11 5368 -3 11 -2 5369 11 5369 11 -2 5368 -6 11 5368 11 5368 5369 5368 11 5369 -2 11 5369 5368 11 5369 11 5369 11 5369 -2 11 5369 5368 11 5368 5369 -4 11 -2 5368 5369 -2 11 -40 0 10 5368 11 5369 -4 11 5369 -3 11 5369 -2 5368 -3 11 5369 11 5368 5369 1539 5369 5368 -2 11 5368 -2 11 5369 11 5368 5369 5368 -3 11 5369 -2 11 1539 5369 -2 11 5368 11 5368 -3 11 5368 -8 11 -40 0 10 -3 5368 5369 -9 11 -2 5369 -5 11 5369 -9 11 -2 5368 11 5369 11 5368 -8 5369 -4 11 -3 5368 11 5368 11 5368 -4 11 -40 0 10 5369 11 5369 -6 11 5369 -5 11 5369 -6 11 5368 5369 11 -2 5368 11 -2 5368 -3 11 -3 5369 5368 -3 11 5368 -3 11 -2 5369 -2 11 5369 -2 11 5368 11 -2 5369 -3 11 5368 -40 0 10 5368 -3 11 5368 11 5368 -2 11 5369 -2 11 5369 -3 11 5369 -2 11 19 11 -2 5369 5368 -2 5369 11 -2 5368 11 5369 -4 11 5368 11 5369 11 5369 11 5368 11 5369 -4 11 5368 11 -2 5369 11 -2 5368 5369 -2 5368 11 -40 0 10 11 5369 11 5368 -3 11 5368 -3 11 5369 5368 5369 11 5368 -4 11 5369 11 5368 -2 5369 11 5368 -2 11 5368 -2 5369 5368 11 5369 -2 11 5368 5369 -2 11 5368 5369 11 5368 -6 11 5369 -4 11 -2 5369 11 -40 0 10 5368 -4 11 5369 -3 11 5369 11 5368 11 5368 5369 11 5368 -2 11 -2 5369 5368 5369 5368 -9 11 5369 -10 11 5368 11 5368 -3 11 5369 -2 5368 5369 -2 5368 11 5369 11 -38 0 2909 2910 22 -2 11 5369 -2 11 5369 -3 11 5369 11 -2 5368 11 5369 11 5368 5369 11 5368 11 5368 -4 11 5368 -2 11 5368 11 5368 5369 -2 11 5369 5368 -2 11 5369 5368 -5 11 5369 -5 11 5369 11 5368 11 5369 5368 5369 -36 0 3141 3142 2911 2912 23 11 5369 -2 5368 5369 11 5369 5368 5369 -3 11 5369 5368 11 5369 11 5369 11 5369 -2 11 5368 -2 5369 -4 11 5368 5369 11 5369 5368 -2 11 5368 11 5368 11 5368 11 5369 5368 11 19 5369 11 5369 5368 5369 11 5369 -6 11 -35 0 1843 3145 3146 1834 11 5368 -3 11 5369 -6 11 5368 -2 11 -2 5369 -4 11 -2 5368 -3 11 -3 5369 11 5369 -2 11 5369 -3 11 5369 -2 11 5368 -2 11 5368 11 5368 -3 11 5368 11 -2 5369 11 -2 5368 11 5368 5369 -2 11 -35 0 1845 3148 11 5368 -3 11 5369 5368 11 5368 11 -2 5368 5369 -2 11 5368 -2 11 -2 5369 -2 11 -2 5369 11 -2 5368 -3 11 5368 -3 11 5368 11 5368 -7 11 5368 5369 -3 11 -3 5368 11 5368 11 5368 -3 11 5369 -3 11 -34 0 3150 1847 5368 -3 11 -2 5369 -2 11 5369 -2 11 5368 -3 11 5368 11 5368 -4 11 5368 5369 11 5369 5368 -3 11 5369 -3 11 5368 -7 11 -2 5369 -4 5368 5369 11 5369 -2 11 5368 11 5369 -4 11 -2 5369 -2 11 2913 2914 -31 0 3153 3154 1849 11 5368 -4 11 5368 -2 11 5369 -6 11 5368 11 5368 11 5368 11 5368 11 -2 5368 -3 11 5369 -2 11 5369 11 5368 -2 5369 5368 -2 11 5369 -2 11 5368 -3 11 -2 5369 11 5368 -9 11 5368 11 5369 5368 2915 2916 2917 2918 -27 8 2921 2922 3157 3158 11 5368 -5 11 5368 11 5368 -2 11 5368 -5 11 5368 11 5369 5368 11 5369 -2 11 5369 -2 11 5368 -2 5369 11 5369 -3 11 5369 5368 11 5368 -2 11 5369 11 5369 -2 11 5369 -2 5368 -5 11 -2 5369 11 -2 5368 11 5369 -3 11 1835 2919 2920 -3 14 3990 14 3988 3990 -2 14 3989 3988 -13 14 3989 -2 14 2923 2924 1834 11 5368 -4 11 5369 -2 11 5369 -2 11 -2 5369 -3 11 5368 -2 11 5369 5368 -2 11 5368 5369 11 -2 5368 -5 11 -2 5368 -2 11 5368 -2 11 5368 5369 -3 11 5369 11 5368 -6 11 5369 -4 11 -2 5369 -4 11 5369 11 5369 5368 5369 -3 11 -2 5369 -11 11 5368 -2 5369 5368 -2 11 1539 -3 11 5368 11 5369 -3 11 5369 5368 -3 11 5368 11 5369 5368 5369 -5 11 5368 -4 11 5368 5369 5368 11 5369 11 5369 5368 11 -3 5369 5368 11 5368 5369 -8 11 5368 -3 11 -2 5369 11 5368 -2 11 5368 -3 11 5369 -4 11 5369 -3 11 5369 -2 5368 11 5369 11 -2 5369 11 5368 -5 11 5369 -2 11 5368 -3 11 5368 11 5368 5369 -7 11 5369 5368 5369 11 5369 -2 5368 5369 -6 11 5368 11 5368 11 5368 11 5369 5368 -2 11 5368 -2 5369 5368 5369 11 5369 5368 -2 11 -3 5368 -4 11 -2 5369 5368 5369 -2 11 5369 -3 11 5369 -2 11 5368 -2 11 5369 5368 5369 5368 5369 5368 -3 5369 11 -2 5369 -3 11 5368 11 -2 5369 -2 11 -2 5368 11 -2 5368 -4 11 5369 -4 11 5369 11 5369 11 -2 5369 5368 5369 11 -2 5368 11 5368 -4 11 5368 -5 11 -2 5368 11 5369 -2 11 5368 5369 11 -2 5369 11 5369 11 5369 11 5369 -4 11 5369 -2 11 5369 -2 11 5369 5368 11 5368 5369 11 5368 -2 11 5368 -4 11 5369 -12 11 -2 5369 -5 11 5369 -8 11 19 -2 5368 -3 11 5368 -5 5369 -5 11 5368 11 5369 -2 5368 11 -2 5368 5369 -5 11 -2 5369 -8 11 -3 5368 -2 11 -3 5368 11 5369 -3 11 5369 11 5369 -2 11 -3 5369 11 5368 -3 11 5369 5368 5369 -2 11 5368 11 19 -6 11 5369 11 5368 11 5369 11 5368 -2 11 5368 5369 11 5368 11 5368 5369 11 -3 5369 11 5368 -2 5369 5368 -2 11 5368 11 5368 11 -2 5368 5369 -2 11 5369 -2 11 5368 -3 11 5369 5368 5369 -2 11 5368 -7 11 -2 5369 5368 -3 11 5368 -3 11 5369 -3 11 5369 -2 11 5368 -2 11 5369 11 5369 -2 5368 5369 11 5368 11 5368 11 -2 5369 -2 11 1539 -6 11 -3 5368 -3 11 -2 5369 -4 11 -2 5368 -4 11 5368 11 5369 -3 11 5368 -3 11 -3 5368 19 -3 11 5368 5369 -3 11 -2 5369 11 5368 -3 11 5368 5369 -2 11 5369 5368 11 5369 -2 11 5369 11 5369 -3 11 5369 -3 11 5369 11 5369 -2 11 5368 -2 5369 -3 11 5368 11 5368 -4 11 5369 -2 5368 11 -2 5368 -5 11 5369 11 5369 -3 11 5368 -3 11 5369 11 5369 11 5369 11 5369 -3 11 5368 11 5369 -2 11 5368 -5 11 5369 11 5369 11 5368 11 5368 11 5369 5368 -2 11 5368 11 5368 -2 11 5369 -2 5368 11 -2 5369 1539 5368 -2 11 5368 5369 11 5369 5368 -3 11 5369 -3 11 5369 11 5368 5369 -10 11 5369 -4 11 5368 -2 11 5368 -2 11 5368 11 5368 11 5368 11 5368 -3 11 5369 11 5368 11 5368 5369 -2 5368 -2 11 -2 5369 5368 -2 5369 -9 11 5369 -10 11 5368 11 5368 -4 11 -2 5368 11 -2 5368 11 5369 11 5369 11 5369 11 5369 -2 11 5369 -2 11 5368 -2 11 5369 -8 11 5369 5368 -5 11 5369 11 5369 5368 5369 11 -2 5368 5369 -2 11 5369 5368 5369 5368 5369 5368 5369 5368)
    )
    (tilemap
      (solid #t)
      (z-pos 1)
      (name "a")
      (width 100)
      (height 35)
      (tiles -22 0 1311 -99 0 1311 -99 0 1311 -99 0 1311 -99 0 1311 -99 0 1311 -99 0 1311 -99 0 1311 -99 0 1311 -99 0 1311 -99 0 1311 -99 0 1311 -99 0 1311 -99 0 1311 -99 0 1311 -99 0 1311 -99 0 1311 -99 0 1311 -99 0 1311 -99 0 1311 -99 0 1311 -99 0 1311 -99 0 1311 -99 0 1311 -99 0 1311 -99 0 1311 -977 0)
    )
    (tilemap
      (solid #t)
      (z-pos 2)
      (name "b")
      (width 100)
      (height 35)
      (tiles -26 0 1311 -99 0 1311 -99 0 1311 -99 0 1311 -99 0 1311 -99 0 1311 -99 0 1311 -99 0 1311 -99 0 1311 -99 0 1311 -99 0 1311 -99 0 1311 -99 0 1311 -99 0 1311 -99 0 1311 -99 0 1311 -99 0 1311 -99 0 1311 -99 0 1311 -99 0 1311 -99 0 1311 -99 0 1311 -99 0 1311 -99 0 1311 -99 0 1311 -99 0 1311 -973 0)
    )
  )
  (sector
    (name "bosscutscene")
    (ambient-light
      (color 1 1 1)
    )
    (background
      (color 1 1 1)
      (alignment "bottom")
      (speed 0)
      (image "/images/background/antarctic/snow_panorama.png")
      (z-pos -298)
    )
    (background
      (color 1 1 1)
      (alignment "bottom")
      (scroll-speed-x -5)
      (speed 0)
      (image "/images/background/misc/clouds.png")
    )
    (background
      (color 1 1 1)
      (scroll-speed-x -10)
      (speed 0)
      (image "/images/background/misc/skybox.png")
      (z-pos -299)
    )
    (background
      (color 1 1 1)
      (alignment "bottom")
      (speed 0.4)
      (image "/images/background/antarctic/snow_hills.png")
      (z-pos -297)
    )
    (camera
      (name "Camera")
      (mode "normal")
    )
    (gradient
      (top_color 0.3 0.4 0.75)
      (bottom_color 1 1 1)
      (z-pos -301)
    )
    (music
    )
    (particles-snow
    )
    (scriptedobject
      (z-pos 50)
      (name "yeti")
      (sprite "/images/creatures/yeti/yeti.sprite")
      (x 32)
      (y 832)
    )
    (scripttrigger
      (oneshot #t)
      (script "Tux.deactivate();
Tux.set_dir(true);
wait(0.5);
Tux.set_dir(false);
wait(0.25);
Tux.set_dir(true);
wait(0.25);
Tux.set_dir(false);
wait(0.25);
Tux.set_dir(true);
Text.set_font(\"normal\");
Text.set_text(\"Tux had gone through the door, and it lead him here. But he was confused...\");
Text.fade_in(1);
wait(5);
Text.fade_out(1);
wait(1);
Text.set_text(\"Where was Nolok? He thought Nolok would be here!\");
Text.fade_in(1);
wait(4);
Text.fade_out(1);
wait(1);
play_sound(\"sounds/yeti_gna.wav\");
fade_in_music(\"music/cutscene/boss_theme.music\", 1.5);
Tux.set_dir(false);
Tux.walk(50);
wait(1);
Tux.walk(100);
yeti.set_action(\"walking-right\");
yeti.set_velocity(400, 0);
wait(1);
Tux.walk(150);")
      (button #f)
      (width 32)
      (height 32)
      (x 1440)
      (y 896)
    )
    (scripttrigger
      (script "Tux.set_dir(true);
play_sound(\"sounds/yeti_roar.wav\");
Tux.walk(300);
Text.set_text(\"Tux was being chased by Yeti, the icy island bully!\");
Text.fade_in(1);
wait(4);
Text.fade_out(1);
wait(1);
Effect.fade_out(1);
wait(1);
Text.set_text(\"And all this would lead Tux and Yeti to a bridge, where the fight would start...\");
Text.fade_in(1);
wait(6);
Level.spawn(\"boss\", \"main\", \"fade\");")
      (button #f)
      (width 32)
      (height 32)
      (x 1888)
      (y 896)
    )
    (scripttrigger
      (script "Tux.walk(320);")
      (button #f)
      (width 32)
      (height 32)
      (x 2176)
      (y 896)
    )
    (spawnpoint
      (name "main")
      (x 1440)
      (y 864)
    )
    (tilemap
      (solid #f)
      (z-pos -100)
      (width 200)
      (height 35)
      (tiles -5006 0 1321 1322 1323 1324 -10 0 1321 1322 1323 1324 -39 0 1321 1322 1323 1324 -45 0 1321 1322 1323 1324 -33 0 1321 1322 1323 1324 -53 0 1325 1326 1327 1328 -10 0 1325 1326 1327 1328 -39 0 1325 1326 1327 1328 -45 0 1325 1326 1327 1328 -33 0 1325 1326 1327 1328 -53 0 1329 1330 1331 1332 0 106 107 108 -6 0 1329 1330 1331 1332 4137 4138 4139 4140 4145 4146 4147 4148 -20 0 106 107 108 -8 0 1329 1330 1331 1332 -8 0 106 107 108 -3 0 4145 4146 4147 4148 -14 0 4137 4138 4139 4140 -9 0 1329 1330 1331 1332 -11 0 106 107 108 -7 0 4145 4146 4147 4148 106 107 108 -5 0 1329 1330 1331 1332 -47 0 2623 2624 0 5203 5204 0 1333 1334 1335 1336 0 109 110 111 0 2623 2624 0 24 0 1333 1334 1335 1336 4141 4142 4143 4144 4149 4150 4151 4152 0 2623 2624 2625 2626 24 0 5203 5204 0 2623 2624 2625 2626 0 24 5203 5204 2623 2624 109 110 111 0 24 2625 2626 5203 5204 2623 2624 1333 1334 1335 1336 0 24 0 5203 5204 0 2625 2626 109 110 111 -2 0 24 4149 4150 4151 4152 0 2625 2626 -3 0 24 0 2625 2626 0 5203 5204 0 4141 4142 4143 4144 0 24 -3 0 5203 5204 0 24 1333 1334 1335 1336 0 5203 5204 2625 2626 0 24 2623 2624 -2 0 109 110 111 5203 5204 2625 2626 0 24 0 4149 4150 4151 4152 109 110 111 2623 2624 5203 5204 0 1333 1334 1335 1336 -1247 0)
    )
    (tilemap
      (solid #f)
      (z-pos 100)
      (width 200)
      (height 35)
      (tiles -6000 0 -22 5539 5540 -31 0 5538 -11 5539 5540 -34 0 5538 -20 5539 5540 -40 0 5538 -6 5539 5540 -18 0 5538 -6 5539 5540 -3 0 5549 5545 -3 5549 5543 5545 5543 5545 5543 -2 5549 -2 5543 5545 5543 5545 -2 5543 5545 5543 5549 5547 -4 5539 5540 -13 0 5538 -12 5539 5548 5545 5549 -2 5545 5543 5549 5543 5549 5545 5549 5543 5547 -8 5539 5540 -13 0 5538 -11 5539 5548 -2 5549 5543 -3 5545 5549 5545 -3 5543 5545 5549 5543 5549 5543 5549 5543 5549 5543 5547 -11 5539 5540 -8 0 5538 -19 5539 5548 -2 5545 5543 5549 5543 5545 5547 5539 5540 -13 0 5538 -2 5539 5548 5543 5549 5545 5543 5545 5549 5547 -3 5539 5549 -3 5543 5545 -2 5549 -2 5543 -2 5549 -2 5545 -2 5543 -2 5545 5549 5545 5543 5545 -4 5549 5543 5549 5547 -13 5539 5548 -2 5549 5543 -2 5545 5549 -2 5543 -2 5545 -2 5543 -2 5549 -2 5545 5543 5549 5543 -3 5545 5549 -3 5545 5549 5545 5549 -2 5545 -2 5543 5547 -13 5539 5548 -2 5543 -2 5549 5545 -5 5549 5545 5549 5543 5549 5543 5545 -2 5543 5545 5543 5549 -3 5545 5549 5543 5545 5549 5543 5545 5549 5543 -3 5545 5543 5549 5543 5545 5543 5549 5543 5545 5543 5547 -8 5539 5548 -3 5543 5545 -2 5543 5545 5543 5549 5545 -2 5549 5543 5545 5543 5545 5543 5549 5543 5549 5543 5545 -2 5549 -2 5545 5549 5543 5547 -13 5539 5548 5545 -2 5543 5545 -3 5543 5545 -2 5543 5549 -2 5543 5545 -2 5549 5543 -2 5545 5549 5543 5549 5543 5549 5543 5549 5543 -2 5549 5545 5543 5545 -3 5549 5543 5549 -3 5545 5549 5543 5545 5543 5545 5543 5549 5543 5545 -2 5543 -2 5545 5543 5549 5543 -2 5545 -3 5543 5549 5543 5549 -2 5543 -2 5549 -2 5543 5545 -2 5543 -3 5545 5549 -2 5545 5549 5543 5545 5543 -10 5549 5545 5543 5545 -2 5549 5545 5543 -2 5545 5543 -2 5545 5543 5545 5543 5545 5543 5545 5543 5545 -2 5543 5545 5543 5545 5549 -3 5545 5549 5545 -2 5543 5549 -2 5543 -2 5545 5549 -5 5543 5549 5545 -3 5549 5545 -3 5549 -2 5543 -3 5549 5543 5549 5543 5549 5543 -2 5545 -3 5549 5543 -3 5545 5549 5543 5549 -10 5545 5543 5549 5543 5545 -2 5549 5545 -3 5549 -3 5543 5545 5543 -2 5549 -2 5543 -3 5545 -2 5543 5545 -3 5543 5545 -4 5543 5545 5549 -3 5543 5545 -2 5543 5545 5543 5549 5545 -2 5549 5543 5545 5543 5545 5543 5549 5543 5549 5543 5545 -2 5549 -2 5545 5549 -2 5543 5549 5543 5545 5543 -2 5545 5549 5543 -2 5549 -2 5543 5549 5543 5545 5543 -2 5545 5549 5543 -2 5549 5543 5545 5543 5545 5543 5549 5543 5549 5543 5545 -2 5549 -2 5545 5549 -2 5543 5549 5543 5545 5543 -2 5545 5549 5543 5549 5545 -2 5549 5543 5545 5543 5545 5543 5549 5543 5549 5543 5545 -2 5549 -2 5545 5549 -2 5543 5549 5543 5545 5543 -2 5545 5549 5543 5549 5545 5543 5549 5545 -2 5549 5543 5545 5543 5545 5543 5549 5543 5549 5543 5545 -2 5549 -2 5545 5549 -2 5543 5549 5543 5545 5543 -2 5545 5549 5543 -2 5549 5543 5545 5543 5545 5543 5549 5543 5549 5543 5545 -2 5549 -2 5545 5549 -2 5543 5549 5543 5545 5543 -2 5545 5549 5543 5549 5545 -2 5543 5545 5543 5549 5545 -2 5549 5543 5545 5543 5545 5543 5549 5543 5549 5543 5545 -2 5549 -2 5545 5549 -2 5543 5549 5543 5545 5543 -2 5545 5549 5543 5549)
    )
    (tilemap
      (solid #t)
      (z-pos 0)
      (width 200)
      (height 35)
      (tiles -5600 0 -200 8 -9 14 3988 -5 14 3989 3990 14 3990 3988 -19 14 3989 14 3990 -4 14 3990 -5 14 3990 3989 -26 14 3990 14 3989 -2 14 3990 -16 14 3990 -4 14 3990 -5 14 3989 -3 14 3990 -4 14 3989 -3 14 -2 3990 -2 14 3990 3988 -8 14 3988 -4 14 3989 -3 14 3990 -17 14 3990 -2 14 3989 3990 -6 14 3990 -2 14 3990 -16 14 3990 14 -6 11 -2 5369 -5 11 5369 -8 11 19 -2 5368 -3 11 5368 -8 5369 -2 11 5368 11 5369 -2 5368 11 -2 5368 5369 -5 11 -2 5369 -8 11 -3 5368 -2 11 -3 5368 11 5369 -3 11 5369 11 5369 -2 11 -3 5369 11 5368 -3 11 5369 5368 5369 -2 11 5368 11 19 -5 11 5369 11 5368 -3 11 5368 -3 11 5369 5368 11 19 5369 -2 11 5369 -2 11 5369 -2 11 -2 5369 -2 11 5369 5368 5369 -3 11 5368 11 5369 5368 5369 11 5368 11 5369 5368 -3 11 5368 -2 5369 11 5369 -3 11 5369 -2 11 5368 -5 11 5368 -4 11 5369 -3 11 5368 -2 11 5369 11 5368 -2 11 5369 -2 11 5368 11 5368 -4 11 5368 -3 11 5368 -2 11 5368 -3 11 5369 11 5368 11 5369 11 5368 -2 11 5368 5369 11 5368 11 5368 5369 11 -3 5369 11 5368 -2 5369 5368 -2 11 5368 11 5368 -3 11 5368 -2 11 5369 -2 11 5368 -3 11 5369 5368 5369 -2 11 5368 -7 11 -2 5369 5368 -3 11 5368 -3 11 5369 -3 11 5369 -2 11 5368 -2 11 5369 11 5369 -2 5368 5369 11 5368 11 5368 11 -2 5369 -2 11 1539 -7 11 5369 11 5369 -5 11 -2 5369 5368 -2 11 5368 11 5368 11 5368 11 5368 11 -3 5369 -2 11 5369 5368 5369 11 -2 5369 -3 11 -2 5369 -4 11 5369 -3 11 -2 5368 -2 11 5368 -2 11 5368 5369 -10 11 5368 11 5368 -3 11 5369 -2 11 5369 -2 11 5369 5368 5369 5368 5369 11 5368 11 -2 5369 11 -2 5368 -2 11 5368 -3 11 -3 5369 11 -3 5368 -3 11 -2 5369 -4 11 -2 5368 -4 11 5368 11 5369 -3 11 5368 -3 11 -3 5368 19 -3 11 5368 5369 -3 11 -2 5369 11 5368 -3 11 5368 5369 -2 11 5369 5368 11 5369 -2 11 5369 11 5369 -3 11 5369 -3 11 5369 11 5369 -2 11 5368 -2 5369 -3 11 5368 11 5368 -4 11 5369 -2 5368 11 -2 5368 -5 11 5369 11 5369 -2 11 5368 -2 5369 11 -2 5368 11 5369 -5 11 5368 -2 11 5368 11 5369 5368 -3 11 5368 11 5368 11 5368 5369 19 11 5369 11 5368 -4 11 5368 11 5369 11 5368 -2 5369 11 -2 5368 11 5369 -4 11 5368 11 5369 11 5368 11 5368 11 5368 -6 11 -2 5369 11 5368 11 5369 -2 11 -2 5369 -4 11 -2 5369 11 -2 5369 11 -2 5369 5368 11 5368 -3 5369 5368 -3 11 5368 -3 11 5369 11 5369 11 5369 11 5369 -3 11 5368 11 5369 -2 11 5368 -5 11 5369 11 5369 11 5368 11 5368 11 5369 5368 -2 11 5368 11 5368 -2 11 5369 -2 5368 11 -2 5369 1539 5368 -2 11 5368 5369 11 5369 5368 -3 11 5369 -3 11 5369 11 5368 5369 -10 11 5369 -4 11 5368 -2 11 5368 -2 11 5368 11 5368 11 5368 11 5368 11 5369 5368 11 5368 -7 11 5368 -3 5369 5368 -3 11 5369 -3 5368 5369 -7 11 5369 11 5369 5368 11 5369 11 5369 11 5369 11 5369 -2 11 5369 -2 11 5369 -4 11 5368 -11 11 5368 11 5368 -7 11 5368 19 5369 11 5368 -2 11 5368 5369 -3 11 -2 5368 11 -2 5369 5368 11 5368 -2 5369 5368 11 5369 -2 11 5369 11 5368 11 5368 5369 -2 5368 -2 11 -2 5369 5368 -2 5369 -9 11 5369 -10 11 5368 11 5368 -4 11 -2 5368 11 -2 5368 11 5369 11 5369 11 5369 11 5369 -2 11 5369 -2 11 5368 -2 11 5369 -8 11 5369 5368 -5 11 5369 11 5369 5368 5369 11 -2 5368 5369 -2 11 5369 5368 5369 5368 5369 5368 5369 5368 -2 11 5369 -2 11 5369 -4 11 5368 -10 11 5368 5369 11 5368 -3 11 5368 -3 11 5369 5368 11 5368 5369 -4 11 5368 5369 5368 -2 11 5368 -3 11 5368 -4 11 5369 11 5369 11 5369 11 5369 11 5369 5368 -5 11 5368 11 5368 -3 11 -2 5368 5369 5368 5369 5368 5369 5368 5369 5368 -4 11 5368 -6 11 5369 11 5369)
    )
  )
  (sector
    (name "boss")
    (ambient-light
      (color 1 1 1)
    )
    (background
      (color 1 1 1)
      (alignment "bottom")
      (speed 0.5)
      (image "/images/background/antarctic/arctis_shore.png")
    )
    (background
      (color 1 1 1)
      (alignment "bottom")
      (speed 0)
      (image "/images/background/antarctic/snow_panorama.png")
      (z-pos -301)
    )
    (background
      (scroll-offset-x -5)
      (color 1 1 1)
      (alignment "bottom")
      (speed 0)
      (image "/images/background/misc/clouds.png")
      (z-pos -303)
    )
    (background
      (scroll-offset-x -10)
      (color 1 1 1)
      (alignment "bottom")
      (speed 0)
      (image "/images/background/misc/skybox.png")
      (z-pos -302)
    )
    (camera
      (name "Camera")
      (mode "normal")
    )
    (gradient
      (top_color 0.3 0.4 0.75)
      (bottom_color 1 1 1)
      (z-pos -304)
    )
    (music
      (file "/music/boss/boss_battle_6.music")
    )
    (particles-snow
    )
    (spawnpoint
      (name "main")
      (x 736)
      (y 896)
    )
    (tilemap
      (solid #f)
      (z-pos -100)
      (width 41)
      (height 35)
      (tiles -1435 0)
    )
    (tilemap
      (solid #f)
      (z-pos 100)
      (width 41)
      (height 35)
      (tiles -1271 0 2019 2140 2141 2142 2019 2140 2141 2142 2019 2140 2141 2142 2019 2140 2141 2142 2019 2140 2141 2142 2019 2140 2141 2142 2019 2140 2141 2142 2019 2140 2141 2142 2019 2140 2141 2142 2019 2140 2141 2142 2019 -123 2020)
    )
    (tilemap
      (solid #t)
      (z-pos 0)
      (width 41)
      (height 35)
      (tiles -1230 0 4443 4416 -37 4413 4415 4442 5359 4425 -37 4422 4424 5358 4447 -39 0 4446 5363 -39 0 5362 5363 -39 0 5362)
    )
    (tilemap
      (solid #f)
      (z-pos 1)
      (width 41)
      (height 35)
      (tiles -1189 0 -41 55002 -41 55006 -164 0)
    )
    (yeti
      (z-pos 50)
      (dead-script "Tux.trigger_sequence(\"fireworks\");")
      (x 96)
      (y 864)
      (lives 6)
      (pinch-lives 3)
      (pinch-activation-script "play_music(\"music/boss/boss_battle_6_alternate.music\");")
    )
  )
  (tileset "/images/pure_snow_custom_tiles_v8.2.strf")
)
