(supertux-level
  (version 3)
  (name (_ "Icy Island Zone"))
  (author "SuperTux Player")
  (license "CC-BY-SA 4.0 International")
  (allow-item-pocket "on")
  (icon "")
  (icon-locked "")
  (sector
    (name "main")
    (ambient-light
      (color 1 1 1)
    )
    (level
      (z-pos 50)
      (level "zone1.stl")
      (x 13)
      (y 18)
    )
    (level
      (z-pos 50)
      (level "zone2.stl")
      (x 20)
      (y 17)
    )
    (level
      (z-pos 50)
      (level "boss.stl")
      (x 27)
      (y 16)
    )
    (music
    )
    (special-tile
      (z-pos 50)
      (map-message (_ "Forest Fantasy Round - Comin' Soon! (March 2025)"))
      (invisible-tile #t)
      (passive-message #t)
      (x 32)
      (y 15)
    )
    (special-tile
      (z-pos 50)
      (map-message (_ "Crystalline Cavern Round - Comin' Soon! (March 2025)"))
      (passive-message #t)
      (x 28)
      (y 19)
    )
    (tilemap
      (solid #f)
      (z-pos -100)
      (width 100)
      (height 100)
      (tiles -10000 1)
    )
    (tilemap
      (solid #t)
      (z-pos 1)
      (width 100)
      (height 100)
      (tiles -44 0 273 -7 274 275 -91 0 273 -7 274 275 -91 0 273 -7 274 275 -91 0 273 -7 274 275 -83 0 540 -5 0 291 292 273 -7 274 275 -85 0 291 292 536 0 293 294 273 -7 274 275 -78 0 536 -2 0 540 0 291 292 293 294 -2 0 295 296 273 279 -5 280 281 275 -79 0 291 292 328 329 293 294 295 296 -4 0 276 282 -5 283 284 278 -74 0 540 -4 0 293 294 330 331 295 296 -94 0 295 296 332 333 -15 0 797 -73 0 101 -2 102 124 -2 125 250 -78 0 101 -14 102 113 -5 105 255 125 250 -16 0 356 -6 0 540 -51 0 101 113 -22 105 134 -75 0 104 -23 105 134 -28 0 -3 543 -2 797 543 -3 797 356 543 -36 0 104 -23 105 134 -12 0 356 -14 0 -2 797 -4 0 537 539 -3 0 543 356 -34 0 101 113 -23 105 134 -14 0 356 -11 0 797 356 -2 0 544 -4 0 543 -3 0 356 -34 0 104 -23 105 253 252 -20 0 536 -5 0 543 -12 0 -2 356 797 -32 0 104 -23 105 134 0 797 -10 0 356 -13 0 -2 356 -10 0 543 537 538 539 543 -32 0 104 -22 105 253 252 -26 0 797 -15 0 797 -32 0 104 -21 105 253 252 -5 0 356 -2 0 356 -3 0 356 -30 0 797 -32 0 104 -18 105 110 108 132 252 -3 0 356 -24 0 797 543 -4 0 543 -8 0 543 356 -32 0 107 111 -14 105 110 -2 108 109 -32 0 -2 543 -6 0 541 -3 0 543 356 797 -34 0 107 111 -7 105 110 -5 108 109 -21 0 540 -14 0 356 -2 543 797 356 797 543 -3 797 543 356 -37 0 107 111 -4 105 110 108 109 -10 0 536 -17 0 234 -5 235 236 -57 0 107 -4 108 109 -17 0 536 -10 0 234 235 247 -4 238 245 239 -88 0 234 -2 235 247 238 245 -5 238 239 -86 0 234 235 247 -8 238 245 238 239 -79 0 234 -6 235 247 238 245 -2 238 245 -6 238 245 239 -3 0 543 -75 0 237 -4 238 245 -3 238 -2 245 -7 238 245 238 239 -79 0 237 -4 238 -2 245 238 245 -4 238 245 -5 238 245 239 -79 0 240 244 -4 238 245 -2 238 -2 245 238 -2 245 -5 238 243 242 -80 0 240 244 245 -5 238 245 -4 238 245 -3 238 243 242 -82 0 240 244 -5 238 243 -8 241 242 -84 0 240 -5 241 242 -6657 0)
    )
    (tilemap
      (solid #f)
      (z-pos -1)
      (width 100)
      (height 100)
      (tiles -6 0 204 216 208 209 -2 0 204 -6 205 206 -85 0 204 216 208 213 212 0 204 216 -6 208 215 -3 205 206 -79 0 204 205 216 208 213 212 0 204 216 -11 208 215 206 -3 0 204 -3 205 206 -69 0 204 216 -2 208 213 212 -2 0 207 -3 208 217 213 -4 211 214 -3 208 209 -2 0 204 216 -2 208 213 212 -69 0 207 -3 208 209 -3 0 210 -4 211 212 -4 0 210 -3 211 212 0 204 216 -2 208 213 212 -14 0 257 -3 258 259 -51 0 210 214 213 211 212 -10 0 204 -5 205 206 -2 0 207 208 213 211 212 -11 0 257 -3 258 266 -3 261 267 258 259 -50 0 210 212 0 204 205 206 -6 0 204 205 216 -5 208 209 -2 0 207 213 212 -9 0 257 -3 258 266 -9 261 267 258 259 -50 0 204 216 208 215 206 -4 0 204 216 -5 208 213 211 212 -2 0 210 212 -7 0 257 -2 258 266 -15 261 262 -49 0 204 216 -2 208 213 212 -4 0 207 -4 208 213 211 212 -9 0 257 -3 258 266 -17 261 269 265 -49 0 207 -2 208 213 212 -5 0 210 -4 211 212 -8 0 257 -2 258 266 -21 261 262 -49 0 204 216 208 213 212 -18 0 257 258 266 -23 261 269 265 -49 0 207 -2 208 209 -18 0 257 266 -25 261 262 -50 0 207 217 213 212 -18 0 260 -26 261 262 -50 0 207 208 209 -19 0 260 -26 261 262 -50 0 207 208 209 -19 0 263 -3 264 268 -21 261 269 265 -50 0 207 208 209 -23 0 260 -20 261 269 265 -51 0 207 208 209 -23 0 260 -20 261 262 -52 0 210 214 215 206 -21 0 257 266 -20 261 262 -53 0 210 211 212 -21 0 260 -19 261 269 264 265 -77 0 260 -18 261 269 265 -79 0 263 268 -15 261 269 264 265 -56 0 204 205 206 -22 0 263 264 268 -10 261 269 -2 264 265 -58 0 207 208 215 206 -23 0 263 -10 264 265 -61 0 207 -2 208 209 -96 0 210 214 208 215 206 -14 0 204 -4 205 206 -76 0 207 -2 208 215 206 -11 0 204 205 216 -4 208 209 -74 0 204 206 210 214 -2 208 215 206 -4 0 204 -5 205 216 -5 208 213 212 -74 0 207 215 206 210 214 -2 208 209 -4 0 207 -10 208 213 212 -75 0 207 208 209 0 210 214 208 209 -4 0 210 -10 211 212 -76 0 207 208 215 206 0 210 211 212 -92 0 207 -2 208 209 -6 0 204 -2 205 206 -11 0 204 206 -73 0 210 214 208 215 206 -5 0 210 214 217 215 -7 205 206 -3 0 207 209 -74 0 207 -2 208 215 206 -5 0 210 214 -8 208 209 -3 0 207 215 206 -73 0 210 214 208 213 212 -6 0 210 214 -7 208 209 -3 0 207 208 215 206 -73 0 210 211 212 -8 0 210 211 214 -4 208 213 212 -3 0 210 214 208 215 206 -85 0 210 -4 211 212 -5 0 210 214 208 209 -97 0 210 214 209 -98 0 210 212 -3225 0 1021 -13 1022 1023 -84 0 1021 -15 1025 1023 -82 0 1021 -17 1025 1023 -81 0 1024 -17 1025 1026 -81 0 1024 -17 1025 1026 -81 0 1024 -17 1025 1026 -81 0 1024 -17 1025 1026 -81 0 1024 -17 1025 1026 -81 0 1024 -17 1025 1026 -81 0 1024 -17 1025 1026 -81 0 1024 -17 1025 1026 -81 0 1027 1031 -15 1025 1030 1029 -82 0 1027 1031 -13 1025 1030 1029 -84 0 1027 -13 1028 1029 -1727 0)
    )
    (tilemap
      (solid #f)
      (z-pos 2)
      (width 100)
      (height 100)
      (tiles -639 0 291 292 -2 0 291 292 291 292 -3 0 291 292 -73 0 101 -2 102 103 -8 0 291 292 293 294 -2 0 293 294 293 294 -3 0 293 294 -58 0 101 -8 102 103 -5 0 104 -2 105 106 -2 0 291 292 291 292 291 292 293 294 295 296 -2 0 295 296 295 296 -3 0 295 296 -58 0 104 -8 105 106 -5 0 447 -2 448 449 -2 0 293 294 293 294 293 294 295 296 -71 0 104 -8 105 106 -5 0 450 -2 451 452 101 103 295 296 295 296 295 296 -73 0 447 -8 448 449 -5 0 453 -2 454 455 447 449 -79 0 450 -8 451 452 0 136 138 101 -3 102 103 233 453 455 136 138 -77 0 453 -8 454 455 136 148 141 107 111 -2 105 112 103 0 123 139 141 -77 0 136 138 101 -4 102 103 0 136 148 140 141 0 107 111 -2 105 106 233 0 142 144 -77 0 139 141 104 -4 105 112 103 142 -2 143 144 233 0 107 -2 108 109 -81 0 142 144 107 111 -4 105 106 -91 0 114 -2 0 107 -4 108 109 -4 0 101 102 103 233 -2 0 136 138 -91 0 101 113 105 106 136 138 0 142 144 -82 0 101 -3 102 103 0 233 136 138 104 105 110 109 142 144 0 233 -80 0 123 0 101 113 -2 105 110 109 123 0 142 144 107 108 109 -86 0 101 113 -2 105 110 109 136 138 0 123 0 233 -88 0 107 -3 108 109 0 142 144 -93 0 233 -7687 0)
    )
    (tilemap
      (solid #f)
      (tint 1 0.9372549 0.7490196)
      (z-pos -2)
      (width 100)
      (height 100)
      (tiles -1261 0 249 -11 125 250 -86 0 249 256 -11 105 255 250 -84 0 249 256 -13 105 134 -84 0 128 -14 105 255 125 250 -81 0 249 256 -16 105 134 -81 0 128 -17 105 134 -81 0 128 -17 105 134 -81 0 128 -17 105 134 -81 0 128 -17 105 134 -81 0 251 254 -15 105 253 252 -82 0 251 254 -12 105 253 131 252 -84 0 251 -12 131 252 -7626 0)
    )
    (tilemap
      (solid #f)
      (z-pos 0)
      (width 100)
      (height 100)
      (tiles -553 0 291 292 -98 0 293 294 -98 0 295 296 -1184 0 541 -91 0 542 -100 0 542 541 -7866 0)
    )
    (tilemap
      (solid #f)
      (z-pos 3)
      (width 100)
      (height 100)
      (tiles -746 0 291 292 0 291 292 0 291 292 -59 0 114 -2 0 114 -29 0 293 294 0 293 294 0 293 294 -57 0 101 -6 102 103 -15 0 291 292 -7 0 291 292 0 295 296 0 295 296 0 295 296 -57 0 107 -6 108 109 -15 0 293 294 -5 0 291 292 293 294 -89 0 295 296 291 292 -3 0 293 294 295 296 -91 0 293 294 -3 0 295 296 -82 0 170 101 103 -8 0 295 296 -80 0 170 -7 0 107 109 -85 0 170 101 -2 102 103 -96 0 107 -2 108 109 -205 0 101 103 -98 0 107 109 -8075 0)
    )
    (tilemap
      (solid #f)
      (z-pos 5)
      (width 100)
      (height 100)
      (tiles -850 0 291 292 -94 0 291 292 -2 0 293 294 -81 0 291 292 -9 0 291 292 293 294 -2 0 295 296 -81 0 293 294 -7 0 291 292 293 294 295 296 -85 0 295 296 291 292 291 292 0 291 292 293 294 295 296 -89 0 293 294 293 294 0 293 294 295 296 -91 0 295 296 295 296 0 295 296 -8558 0)
    )
    (tilemap
      (solid #t)
      (z-pos 10)
      (width 100)
      (height 100)
      (tiles -1247 0 797 -186 0 543 -10 0 542 -84 0 10 20 23 -2 0 542 -7 0 544 -76 0 10 -6 20 33 -2 20 15 -5 0 356 -5 0 541 -77 0 21 -6 0 34 31 -80 0 14 -10 20 15 -7 0 41 -99 0 42 -8071 0)
    )
    (tilemap
      (solid #f)
      (z-pos 4)
      (width 100)
      (height 100)
      (tiles -812 0 123 -4 0 123 -8 0 123 -18 0 291 292 -67 0 233 123 -29 0 293 294 -98 0 295 296 -87 0 291 292 -84 0 123 -13 0 293 294 -98 0 295 296 -179 0 114 -215 0 123 -89 0 123 -192 0 123 114 -97 0 123 -7886 0)
    )
    (tilemap
      (solid #f)
      (z-pos 6)
      (width 100)
      (height 100)
      (tiles -949 0 291 292 291 292 -96 0 293 294 293 294 -92 0 291 292 -2 0 295 296 295 296 -90 0 291 292 293 294 -89 0 291 292 -3 0 291 292 293 294 295 296 -89 0 293 294 -3 0 293 294 295 296 -91 0 295 296 -3 0 295 296 -8457 0)
    )
    (tilemap
      (solid #f)
      (z-pos 7)
      (width 100)
      (height 100)
      (tiles -1050 0 291 292 -98 0 293 294 -98 0 295 296 -185 0 291 292 0 291 292 -95 0 293 294 0 293 294 -95 0 295 296 0 295 296 -8358 0)
    )
    (tilemap
      (solid #f)
      (z-pos 8)
      (width 100)
      (height 100)
      (tiles -1149 0 291 292 291 292 -96 0 293 294 293 294 -96 0 295 296 295 296 -8647 0)
    )
    (tilemap
      (solid #f)
      (z-pos 9)
      (width 100)
      (height 100)
      (tiles -1250 0 291 292 -98 0 293 294 -98 0 295 296 -175 0 20 -81 0 19 -8290 0)
    )
    (tilemap
      (solid #f)
      (z-pos 100)
      (width 100)
      (height 100)
      (tiles -1248 0 291 292 -98 0 293 294 -98 0 295 296 -184 0 291 292 -98 0 293 294 291 292 -3 0 291 292 -91 0 295 296 293 294 -3 0 293 294 -93 0 295 296 -3 0 295 296 -8057 0)
    )
    (tilemap
      (solid #f)
      (z-pos 101)
      (width 100)
      (height 100)
      (tiles -1349 0 291 292 -98 0 293 294 -98 0 295 296 -8449 0)
    )
    (tilemap
      (solid #f)
      (z-pos 102)
      (width 100)
      (height 100)
      (tiles -1446 0 291 292 291 292 -96 0 293 294 293 294 -96 0 295 296 295 296 -8350 0)
    )
    (tilemap
      (solid #f)
      (z-pos 99)
      (width 100)
      (height 100)
      (tiles -1643 0 291 292 -98 0 293 294 -98 0 295 296 -8155 0)
    )
    (tilemap
      (solid #f)
      (z-pos 98)
      (width 100)
      (height 100)
      (tiles -1544 0 291 292 -98 0 293 294 -98 0 295 296 -8254 0)
    )
    (tilemap
      (solid #f)
      (z-pos 104)
      (width 100)
      (height 100)
      (tiles -1547 0 291 292 291 292 -94 0 291 292 293 294 293 294 -82 0 291 292 -10 0 293 294 295 296 295 296 -82 0 293 294 291 292 291 292 0 291 292 -3 0 295 296 -86 0 295 296 293 294 293 294 0 293 294 -93 0 295 296 295 296 0 295 296 -7958 0)
    )
    (tilemap
      (solid #f)
      (z-pos 103)
      (width 100)
      (height 100)
      (tiles -1532 0 291 292 -98 0 293 294 -98 0 295 296 -8266 0)
    )
    (tilemap
      (solid #f)
      (z-pos 105)
      (width 100)
      (height 100)
      (tiles -1744 0 291 292 291 292 -84 0 291 292 -8 0 291 292 293 294 293 294 -84 0 293 294 291 292 291 292 291 292 -2 0 293 294 295 296 295 296 -84 0 295 296 293 294 293 294 293 294 -2 0 295 296 -90 0 295 296 295 296 295 296 -7860 0)
    )
    (tilemap
      (solid #f)
      (z-pos 106)
      (width 100)
      (height 100)
      (tiles -1941 0 291 292 0 545 -95 0 545 293 294 0 546 -95 0 546 295 296 -7857 0)
    )
    (tilemap
      (solid #f)
      (tint 1 1 1 0.2)
      (z-pos 8)
      (width 100)
      (height 100)
      (tiles -6958 0 1032 -13 1033 1034 -84 0 1032 -15 1036 1034 -82 0 1032 -17 1036 1034 -81 0 1035 -17 1036 1037 -81 0 1035 -17 1036 1037 -81 0 1035 -17 1036 1037 -81 0 1035 -17 1036 1037 -81 0 1035 -17 1036 1037 -81 0 1035 -17 1036 1037 -81 0 1035 -17 1036 1037 -81 0 1035 -17 1036 1037 -81 0 1038 -17 1036 1037 -82 0 1038 -15 1036 1037 -84 0 1038 -13 1039 1040 -1727 0)
    )
    (tilemap
      (solid #f)
      (z-pos 11)
      (width 100)
      (height 100)
      (tiles -1609 0 115 -99 0 116 -8290 0)
    )
    (worldmap-spawnpoint
      (z-pos 50)
      (name "main")
      (x 9)
      (y 18)
    )
  )
  (tileset "images/ice_world.strf")
)
