(supertux-level
  (version 3)
  (name (_ "Radical Ruins Round"))
  (author "Sophie Ball")
  (license "CC-BY-SA 4.0 International")
  (allow-item-pocket "on")
  (icon "")
  (icon-locked "")
  (sector
    (name "main")
    (ambient-light
      (color 1 1 1)
    )
    (level
      (z-pos 50)
      (level "zone1.stl")
      (x 27)
      (y 14)
    )
    (level
      (z-pos 50)
      (level "zone2.stl")
      (x 23)
      (y 18)
    )
    (music
      (file "/music/worldmap/radical_ruins.music")
    )
    (teleporter
      (z-pos 50)
      (worldmap "/levels/round2/worldmap.stwm")
      (sector "main")
      (spawnpoint "main")
      (message (_ "Go back to Crystalline Cavern Round?"))
      (x 31)
      (y 9)
    )
    (teleporter
      (z-pos 50)
      (worldmap "/levels/round45/worldmap.stwm")
      (sector "main")
      (spawnpoint "main")
      (message (_ "Go to Secret Stronghold Zone?"))
      (x 23)
      (y 21)
    )
    (tilemap
      (solid #f)
      (z-pos -100)
      (width 100)
      (height 29)
      (tiles -2900 1)
    )
    (tilemap
      (solid #t)
      (tint 1 1 1 0.1)
      (z-pos -99)
      (width 100)
      (height 29)
      (tiles -2900 1036)
    )
    (tilemap
      (solid #t)
      (z-pos 0)
      (width 100)
      (height 29)
      (tiles -217 0 536 -110 0 291 292 291 292 291 292 291 292 291 292 -82 0 291 292 291 292 291 292 291 292 293 294 293 294 293 294 293 294 293 294 291 292 291 292 -76 0 291 292 293 294 293 294 293 294 293 294 295 296 295 296 295 296 295 296 295 296 293 294 293 294 291 292 -3 0 536 -68 0 291 292 293 294 295 296 295 296 295 296 295 296 -10 0 295 296 295 296 293 294 291 292 -58 0 536 -11 0 293 294 295 296 -22 0 295 296 293 294 291 292 -68 0 295 296 -6 0 1021 -15 1022 1023 -3 0 295 296 293 294 291 292 -69 0 1021 -4 1022 -17 1025 -2 1022 1023 -2 0 295 296 293 294 -68 0 1024 -25 1025 1022 1023 -2 0 295 296 -67 0 1021 -28 1025 -70 0 1024 -29 1025 1023 -68 0 1021 -30 1025 1026 -68 0 1024 -30 1025 1026 -68 0 1024 -29 1025 1030 1029 -10 0 540 -57 0 1024 -28 1025 1030 1029 -69 0 1024 -27 1025 1030 1029 -60 0 540 -9 0 1024 -26 1025 1030 1029 -71 0 1027 1031 -24 1025 1030 1029 -73 0 1027 1031 -21 1025 1030 1029 -76 0 1027 -20 1025 1029 -79 0 1027 -18 1028 1029 -173 0 540 -235 0 540 -252 0)
    )
    (tilemap
      (solid #f)
      (tint 1 1 1 0.1)
      (z-pos 100)
      (width 100)
      (height 29)
      (tiles -824 0 1032 -15 1033 1034 -78 0 1032 -4 1033 -17 1036 -2 1033 1034 -74 0 1035 -25 1036 1033 1034 -71 0 1032 -28 1036 -70 0 1035 -29 1036 1034 -68 0 1032 -30 1036 1037 -68 0 1035 -30 1036 1037 -68 0 1035 -30 1036 1040 -68 0 1035 -29 1036 1040 -69 0 1035 -28 1036 1040 -70 0 1035 -27 1036 1040 -71 0 1038 -26 1036 1040 -73 0 1038 -23 1036 1040 -76 0 1038 -20 1036 1040 -79 0 1038 -18 1039 1040 -662 0)
    )
    (tilemap
      (solid #t)
      (z-pos 1)
      (width 100)
      (height 29)
      (tiles -429 0 291 292 291 292 291 292 291 292 -84 0 291 292 291 292 291 292 291 292 293 294 293 294 293 294 293 294 291 292 291 292 -78 0 291 292 293 294 293 294 293 294 293 294 295 296 295 296 295 296 295 296 293 294 293 294 291 292 -72 0 291 292 291 292 293 294 295 296 295 296 295 296 295 296 -8 0 295 296 295 296 293 294 291 292 -70 0 293 294 293 294 295 296 -20 0 295 296 293 294 291 292 -68 0 295 296 295 296 -12 0 19 -11 0 295 296 293 294 291 292 291 292 -69 0 257 -3 258 259 -6 0 21 -13 0 295 296 293 294 293 294 -67 0 257 258 266 -3 261 267 258 259 -4 0 21 -3 0 257 258 259 -3 0 257 258 259 -3 0 295 296 295 296 -66 0 257 266 -3 261 269 -3 264 265 -4 0 21 -2 0 257 266 261 262 -2 0 257 266 261 267 259 -72 0 263 -4 264 265 -8 0 21 0 257 266 -2 261 262 0 257 266 -3 261 262 -72 0 257 -2 258 259 -2 0 10 -7 20 15 0 260 -3 261 262 0 260 -4 261 262 -72 0 260 -2 261 262 -2 0 21 -9 0 260 -2 261 269 265 257 266 -3 261 269 265 -72 0 263 268 261 262 -2 0 21 -9 0 260 261 269 265 0 260 -3 261 269 265 -74 0 260 261 267 259 0 21 -6 0 257 258 259 263 264 265 -2 0 260 261 269 264 265 -75 0 260 -2 261 262 0 21 -3 0 257 -2 258 266 261 262 -5 0 263 264 265 -77 0 263 -2 264 265 0 21 -2 0 257 266 -3 261 269 265 -90 0 21 -2 0 260 -3 261 269 265 -91 0 22 -2 0 263 -3 264 265 -769 0)
    )
    (tilemap
      (solid #f)
      (z-pos -1)
      (width 100)
      (height 29)
      (tiles -428 0 257 -9 258 259 -80 0 257 -8 258 266 -9 261 267 -2 258 259 -75 0 257 258 266 -21 261 267 -2 258 259 -71 0 257 266 -26 261 267 258 259 -68 0 257 266 -7 261 269 -15 264 268 -5 261 267 259 -66 0 257 266 -3 261 269 -4 264 265 -15 0 263 -2 264 268 -3 261 267 258 259 -63 0 257 266 -3 261 269 265 -23 0 263 264 268 -3 261 267 259 -61 0 257 266 -3 261 269 265 -26 0 260 -4 261 262 -61 0 260 -3 261 269 265 -27 0 263 268 -3 261 267 259 -59 0 257 266 -2 261 269 265 -29 0 260 -4 261 262 -59 0 260 -3 261 262 -30 0 260 -4 261 262 -59 0 260 -3 261 262 -29 0 257 266 -4 261 262 -59 0 260 -3 261 262 -28 0 257 266 -5 261 262 -59 0 260 -3 261 262 -27 0 257 266 -5 261 269 265 -59 0 260 -3 261 262 -26 0 257 266 -6 261 262 -60 0 260 -3 261 267 259 -23 0 257 258 266 -6 261 269 265 -60 0 263 268 -3 261 267 259 -20 0 257 258 266 -7 261 269 265 -62 0 263 264 268 -2 261 267 259 -18 0 257 266 -8 261 269 265 -65 0 263 268 -2 261 267 -18 258 266 -7 261 269 264 265 -67 0 263 268 -25 261 269 -2 264 265 -70 0 263 264 268 -21 261 269 264 265 -75 0 263 -4 264 268 -12 261 269 -3 264 265 -82 0 263 -12 264 265 -263 0)
    )
    (tilemap
      (solid #f)
      (z-pos 2)
      (width 100)
      (height 29)
      (tiles -530 0 291 292 291 292 291 292 -86 0 291 292 -5 0 545 293 294 293 294 293 294 545 -84 0 545 293 294 -5 0 546 295 296 295 296 295 296 546 -77 0 291 292 291 292 -3 0 546 295 296 -90 0 293 294 293 294 0 291 292 291 292 291 292 -89 0 295 296 295 296 0 293 294 293 294 293 294 -10 0 291 292 -4 0 291 292 -3 0 291 292 291 292 -69 0 295 296 295 296 295 296 -10 0 293 294 -4 0 293 294 291 292 0 293 294 293 294 -85 0 295 296 -4 0 295 296 293 294 0 295 296 295 296 -68 0 291 292 -23 0 295 296 -73 0 293 294 -98 0 295 296 -110 0 291 292 -96 0 291 292 293 294 -96 0 293 294 295 296 -96 0 295 296 -970 0)
    )
    (tilemap
      (solid #f)
      (z-pos 3)
      (width 100)
      (height 29)
      (tiles -913 0 291 292 291 292 -96 0 293 294 293 294 0 291 292 291 292 -91 0 295 296 295 296 0 293 294 293 294 -14 0 291 292 -9 0 291 292 291 292 -67 0 295 296 295 296 -12 0 291 292 293 294 -2 0 291 292 291 292 -3 0 293 294 293 294 -83 0 293 294 295 296 -2 0 293 294 293 294 -3 0 295 296 295 296 -68 0 291 292 -13 0 295 296 -4 0 295 296 295 296 -75 0 293 294 -98 0 295 296 -206 0 291 292 291 292 -96 0 293 294 293 294 -96 0 295 296 295 296 -869 0)
    )
    (tilemap
      (solid #f)
      (z-pos 4)
      (width 100)
      (height 29)
      (tiles -1014 0 291 292 -98 0 293 294 -98 0 295 296 -32 0 291 292 -85 0 291 292 -2 0 291 292 291 292 -5 0 293 294 -85 0 293 294 -2 0 293 294 293 294 -5 0 295 296 -68 0 291 292 -15 0 295 296 -2 0 295 296 295 296 -75 0 293 294 -98 0 295 296 -1180 0)
    )
    (tilemap
      (solid #f)
      (z-pos 5)
      (width 100)
      (height 29)
      (tiles -1113 0 291 292 -98 0 293 294 -98 0 295 296 -32 0 291 292 291 292 -83 0 291 292 -4 0 291 292 -5 0 293 294 293 294 -83 0 293 294 -4 0 293 294 -5 0 295 296 295 296 -68 0 291 292 -13 0 295 296 -4 0 295 296 -77 0 293 294 -98 0 295 296 -1079 0)
    )
    (tilemap
      (solid #f)
      (z-pos 6)
      (width 100)
      (height 29)
      (tiles -1212 0 291 292 -98 0 293 294 -98 0 295 296 -32 0 291 292 291 292 -89 0 291 292 -5 0 293 294 293 294 -89 0 293 294 -5 0 295 296 295 296 -89 0 295 296 -1159 0)
    )
    (tilemap
      (solid #f)
      (z-pos 7)
      (width 100)
      (height 29)
      (tiles -1313 0 291 292 -98 0 293 294 -98 0 295 296 -32 0 291 292 291 292 -96 0 293 294 293 294 -96 0 295 296 295 296 -1149 0)
    )
    (tilemap
      (solid #f)
      (z-pos 8)
      (width 100)
      (height 29)
      (tiles -1412 0 291 292 -98 0 293 294 -98 0 295 296 -30 0 291 292 291 292 291 292 -94 0 293 294 293 294 293 294 -94 0 295 296 295 296 295 296 -1050 0)
    )
    (tilemap
      (solid #f)
      (z-pos 9)
      (width 100)
      (height 29)
      (tiles -1513 0 291 292 -98 0 293 294 -98 0 295 296 -28 0 291 292 291 292 291 292 -94 0 293 294 293 294 293 294 -94 0 295 296 295 296 295 296 -951 0)
    )
    (tilemap
      (solid #f)
      (z-pos 10)
      (width 100)
      (height 29)
      (tiles -1612 0 291 292 -98 0 293 294 -98 0 295 296 -26 0 291 292 291 292 291 292 291 292 -92 0 293 294 293 294 293 294 293 294 -92 0 295 296 295 296 295 296 295 296 -852 0)
    )
    (tilemap
      (solid #f)
      (z-pos 11)
      (width 100)
      (height 29)
      (tiles -1713 0 291 292 -98 0 293 294 -98 0 295 296 -24 0 291 292 291 292 291 292 291 292 -92 0 293 294 293 294 293 294 293 294 -92 0 295 296 295 296 295 296 295 296 -753 0)
    )
    (tilemap
      (solid #f)
      (z-pos 12)
      (width 100)
      (height 29)
      (tiles -1812 0 291 292 291 292 -96 0 293 294 293 294 -96 0 295 296 295 296 -22 0 291 292 291 292 291 292 291 292 -92 0 293 294 293 294 293 294 293 294 -92 0 295 296 295 296 295 296 295 296 -654 0)
    )
    (tilemap
      (solid #f)
      (z-pos 13)
      (width 100)
      (height 29)
      (tiles -1915 0 291 292 -98 0 293 294 -98 0 295 296 -8 0 291 292 291 292 291 292 291 292 291 292 291 292 291 292 291 292 291 292 -82 0 293 294 293 294 293 294 293 294 293 294 293 294 293 294 293 294 293 294 -82 0 295 296 295 296 295 296 295 296 295 296 295 296 295 296 295 296 295 296 -557 0)
    )
    (tilemap
      (solid #f)
      (z-pos 90)
      (width 100)
      (height 29)
      (tiles -2117 0 291 292 291 292 291 292 291 292 -92 0 293 294 293 294 293 294 293 294 0 291 292 291 292 291 292 291 292 291 292 291 292 291 292 -77 0 295 296 295 296 295 296 295 296 0 293 294 293 294 293 294 293 294 293 294 293 294 293 294 -86 0 295 296 295 296 295 296 295 296 295 296 295 296 295 296 -460 0)
    )
    (tilemap
      (solid #f)
      (z-pos 89)
      (width 100)
      (height 29)
      (tiles -2016 0 291 292 -98 0 293 294 -98 0 295 296 -682 0)
    )
    (tilemap
      (solid #f)
      (z-pos 91)
      (width 100)
      (height 29)
      (tiles -2218 0 291 292 291 292 291 292 291 292 -92 0 293 294 293 294 293 294 293 294 0 291 292 291 292 291 292 291 292 291 292 -81 0 295 296 295 296 295 296 295 296 0 293 294 293 294 293 294 293 294 293 294 -90 0 295 296 295 296 295 296 295 296 295 296 -363 0)
    )
    (tilemap
      (solid #f)
      (z-pos 92)
      (width 100)
      (height 29)
      (tiles -2323 0 291 292 291 292 -96 0 293 294 293 294 -96 0 295 296 295 296 -373 0)
    )
    (worldmap-spawnpoint
      (z-pos 50)
      (name "a")
      (x 4)
      (y -2)
    )
    (worldmap-spawnpoint
      (z-pos 50)
      (name "main")
      (x 31)
      (y 10)
    )
  )
  (tileset "images/ice_world.strf")
)
