(supertux-level
  (version 3)
  (name (_ "Level 1"))
  (author "SuperTux Player")
  (license "CC-BY-SA 4.0 International")
  (allow-item-pocket "inherit")
  (icon "")
  (icon-locked "")
  (statistics
    (enable-coins #t)
    (enable-badguys #f)
    (enable-secrets #t)
  )
  (sector
    (name "main")
    (ambient-light
      (color 1 1 1)
    )
    (background
      (color 1 1 1)
      (speed 0.5)
      (image "images/background/antarctic/arctis2.png")
    )
    (camera
      (name "Camera")
      (mode "normal")
    )
    (gradient
      (top_color 0.3 0.4 0.75)
      (bottom_color 1 1 1)
      (z-pos -301)
    )
    (haywire
      (z-pos 50)
      (x 2048)
      (y 416)
    )
    (music
    )
    (spawnpoint
      (name "main")
      (x 64)
      (y 512)
    )
    (sspiky
      (z-pos 50)
      (x 480)
      (y 544)
    )
    (tilemap
      (solid #f)
      (z-pos -100)
      (width 100)
      (height 35)
      (tiles -3500 0)
    )
    (tilemap
      (solid #f)
      (z-pos 100)
      (width 100)
      (height 35)
      (tiles -3500 0)
    )
    (tilemap
      (solid #t)
      (z-pos 0)
      (width 100)
      (height 35)
      (tiles -1361 0 55224 55225 -3 55002 55003 -90 0 55224 55225 55222 55223 55232 55233 -3 55006 55007 -86 0 55224 55225 55222 55223 55232 55233 55230 55231 -88 0 55224 55225 55222 55223 55232 55233 55230 55231 -43 0 -15 55002 55226 55227 -28 0 55224 55225 55222 55223 55232 55233 55230 55231 -47 0 -15 55006 55234 55235 55228 55229 55226 55227 -20 0 55224 55225 55222 55223 55232 55233 55230 55231 -68 0 55236 55237 55234 55235 55228 55229 -3 55002 55003 -5 0 55001 -6 55002 55222 55223 55232 55233 55230 55231 -76 0 55236 55237 -3 55006 55007 -5 0 55005 -6 55006 55230 55231 -1459 0)
    )
    (tilemap
      (solid #t)
      (tint 0.5 0.5 0.7)
      (z-pos -99)
      (width 100)
      (height 35)
      (tiles -1361 0 6978 6979 -3 2385 2386 -90 0 6978 6979 6988 6989 6982 6983 -3 2388 2389 -86 0 6978 6979 6988 6989 6982 6983 6992 6993 2988 -2 2391 2397 2398 2392 -82 0 6978 6979 6988 6989 6982 6983 6992 6993 2988 -3 2391 2396 2391 2399 2391 2396 2392 -33 0 -15 2385 6980 6981 -28 0 6978 6979 6988 6989 6982 6983 6992 6993 2988 2391 2399 2391 2396 -4 2391 2399 2391 2397 2399 2392 -33 0 -15 2388 6984 6985 6986 6987 6980 6981 -20 0 6978 6979 6988 6989 6982 6983 6992 6993 2988 2391 2398 2391 2396 2391 2397 2399 2391 2396 -2 2391 2398 2399 2396 2399 2398 2392 -33 0 -5 2391 2397 2398 2391 -2 2397 2391 2397 2399 -3 2391 2992 6990 6991 6984 6985 6986 6987 -3 2385 -6 0 2384 -6 2385 6988 6989 6982 6983 6992 6993 2988 2391 2399 -3 2391 2399 2391 -2 2397 2391 2398 2391 2396 2398 2391 2396 2391 2396 -2 2391 2973 -33 0 -2 2391 2396 2391 -2 2397 2399 -13 2391 2992 6990 6991 -3 2388 2392 -5 0 2387 -6 2388 6992 6993 2988 2391 2399 -2 2397 2399 2391 2399 2397 2399 -3 2391 2398 2397 2391 2398 2391 2398 2391 2399 -2 2391 2397 2957 2974 -33 0 -3 2391 2396 2391 2397 2391 2398 2399 -3 2391 2399 -5 2391 2397 2399 2398 -3 2391 2396 2399 2392 -5 0 2390 2398 2397 -3 2391 2398 2396 -3 2391 2396 2399 -7 2391 2396 -2 2391 -2 2398 -4 2391 -2 2396 -2 2391 2392 -34 0 2391 2398 -3 2391 2397 -2 2391 2396 -2 2391 2397 2396 2399 2397 2391 2398 -2 2391 2396 2398 2396 -3 2391 2396 2392 -5 0 2390 -2 2391 2398 -3 2391 2397 -3 2391 2396 -2 2391 2396 2391 -2 2397 2399 -2 2391 2396 -2 2391 -2 2399 -2 2391 2398 2399 2391 2397 2391 2392 -34 0 -2 2391 -2 2399 2391 2397 2396 2398 -5 2391 2399 2391 2396 2397 2391 2396 2391 2399 2391 2399 2391 2396 2391 2392 -5 0 2390 2399 2397 -2 2391 2397 -2 2391 2399 -2 2398 -2 2391 2398 -2 2391 2397 -3 2391 2396 2391 2397 -4 2391 2397 2398 2391 2398 2397 2391 2392 -34 0 -3 2391 2396 2391 2398 2399 -3 2391 -2 2398 -4 2391 -2 2397 -3 2391 2397 2399 2397 2391 2396 2392 -5 0 2390 2399 -4 2391 2396 2398 -3 2391 2397 -2 2391 2398 -6 2391 2396 2391 2397 2391 2397 2391 2396 2391 2397 2396 -2 2391 2973 -34 0 -2 2396 2398 -11 2391 2399 2391 2399 -2 2391 2396 2397 -4 2391 2399 2973 -5 0 2967 2391 2397 2391 2399 -2 2391 2398 2396 -2 2391 2397 2391 2396 -2 2391 2397 -5 2391 2397 2391 2399 2397 2391 2399 -2 2391 2399 2391 2957 2974 -34 0 2397 2399 -2 2391 2399 2391 2397 2396 2399 -2 2396 -2 2391 -2 2396 -2 2391 2398 2391 2398 -5 2391 2957 2974 -5 0 2968 2962 2396 -2 2397 2398 2399 -2 2391 2398 -2 2391 2399 -2 2391 2399 2398 -3 2391 2396 -2 2391 2398 2397 -2 2391 2397 2398 2397 2396 2391 2392 -35 0 2398 2391 2398 2397 2399 -3 2391 2399 2398 -11 2391 2397 -2 2399 2396 2392 -7 0 2390 2398 2391 2398 -2 2391 2397 -3 2391 2397 2391 2398 2396 2398 -5 2391 2396 -4 2391 2397 2399 2391 2399 2391 2398 2392 -35 0 2398 -3 2391 2399 2396 2397 2391 2399 2391 2398 2399 2391 2396 -5 2391 2398 -2 2391 2396 -2 2391 2392 -7 0 2967 -5 2391 2396 2399 2391 2399 -2 2397 2399 -6 2391 2396 2391 -2 2397 2391 2398 2396 -2 2391 2397 2391 2399 2973 -35 0 2399 2398 2399 2391 -2 2399 -3 2391 2396 2391 2399 2398 -2 2391 2396 2397 2391 -2 2396 -4 2391 2398 2973 -7 0 2968 2962 2391 2399 -2 2391 2397 2396 2391 2397 -4 2391 2396 -5 2391 2397 2396 2399 -2 2391 2397 2398 2391 -2 2399 2957 2974 -35 0 -6 2391 2399 2398 -5 2391 2399 -8 2391 2396 2397 2957 2974 -8 0 2390 -2 2398 2399 -2 2391 2396 2391 2398 -2 2397 2391 2397 2396 2398 -5 2391 2399 -8 2391 2392 -36 0 -3 2391 2399 2391 2396 2391 2398 2391 2396 -2 2391 2397 2398 2391 2396 2391 2397 2398 2391 2398 2399 2398 2391 2392 -9 0 2390 -2 2391 2396 -2 2391 2399 -2 2391 2396 -3 2391 2399 2397 2398 -2 2391 2396 -6 2391 2398 2399 2397 2391 2392 -36 0 2391 2398 2396 2398 -3 2391 -2 2398 -4 2391 -2 2397 -4 2391 2396 2391 2399 -2 2391 2392 -9 0 2967 -2 2391 2396 2398 -3 2391 -2 2399 2391 2397 -3 2391 2397 2399 -2 2391 2398 2396 2399 -2 2391 2399 2391 2399 -2 2391 2392 -36 0 -3 2391 2396 -3 2391 2398 2391 2399 2391 2398 2391 2398 -3 2391 2397 2391 2399 -2 2391 2397 2391 2973 -9 0 2968 2962 2391 2399 2396 -2 2391 2396 2391 2396 -2 2391 2399 -2 2396 2391 2398 2399 -2 2396 2391 2397 2399 2391 2398 2397 -3 2391 2392 -36 0 -2 2391 2398 2391 2396 2391 2398 2399 -2 2396 -2 2391 2398 2399 2396 2399 2398 -6 2391 2957 2974 -10 0 2967 -2 2391 2397 2391 2397 -4 2391 2397 2396 2391 -2 2396 2391 2399 2391 2399 -2 2391 2398 -2 2391 2398 -2 2391 2396 2973 -36 0)
    )
  )
  (tileset "/images/pure_snow_custom_tiles_v8.2.strf")
)
