(supertux-level
  (version 3)
  (name (_ "The Ghost Tree"))
  (author "Sophie Ball")
  (note (_ "Boss Fight time!"))
  (license "CC-BY-SA 4.0 International")
  (allow-item-pocket "inherit")
  (icon "")
  (icon-locked "")
  (statistics
    (enable-coins #t)
    (enable-badguys #f)
    (enable-secrets #t)
  )
  (sector
    (name "main")
    (ambient-light
      (color 0.7 0.6 0.7)
    )
    (background
      (color 0 0 0)
      (speed 0)
      (image "/images/background/misc/sky.png")
      (z-pos -318)
    )
    (background
      (color 1 1 1)
      (alignment "bottom")
      (speed 0.5)
      (image "/images/background/forest/gh_tree_front.png")
      (z-pos -308)
    )
    (background
      (color 0.8 0.8 0.8)
      (alignment "bottom")
      (speed 0.25)
      (image "/images/background/forest/gh_tree_back.png")
      (z-pos -310)
    )
    (background
      (scroll-offset-y -50)
      (color 0.6 0.6 0.6)
      (alignment "bottom")
      (speed 0.125)
      (image "/images/background/forest/gh_tree_back.png")
      (z-pos -312)
    )
    (background
      (scroll-offset-y -100)
      (color 0.4 0.4 0.4)
      (alignment "bottom")
      (speed 0.07)
      (image "/images/background/forest/gh_tree_back.png")
      (z-pos -314)
    )
    (background
      (color 0 0 0)
      (alignment "bottom")
      (speed 0)
      (image "/images/background/forest/mountain_panorama.png")
      (z-pos -316)
    )
    (background
      (color 1 1 1)
      (speed 0)
      (fill #t)
      (image "/images/background/misc/vignette.png")
      (z-pos 302)
    )
    (background
      (color 1 1 1)
      (scroll-speed-x -50)
      (speed 0.5)
      (image "/images/background/misc/fog.png")
      (z-pos 301)
    )
    (camera
      (name "Camera")
      (mode "normal")
    )
    (ghosttree
      (z-pos -200)
      (dead-script "Tux.trigger_sequence(\"fireworks\");")
      (x 771.3334)
      (y 761.5555)
      (hud-icon "images/creatures/ghosttree/hudlife.png")
      (lives 3)
      (pinch-lives 0)
    )
    (gradient
      (top_color 0 0 0)
      (bottom_color 1 1 1)
      (z-pos -320)
    )
    (gradient
      (top_color 1 1 1 0.2)
      (bottom_color 1 1 1 0.2)
    )
    (gradient
      (top_color 1 1 1 0.2)
      (bottom_color 1 1 1 0.2)
      (z-pos -309)
    )
    (gradient
      (top_color 1 1 1 0.2)
      (bottom_color 1 1 1 0.2)
      (z-pos -311)
    )
    (gradient
      (top_color 1 1 1 0.2)
      (bottom_color 1 1 1 0.2)
      (z-pos -313)
    )
    (gradient
      (top_color 1 1 1 0.2)
      (bottom_color 1 1 1 0.2)
      (z-pos -315)
    )
    (gradient
      (top_color 1 1 1 0.2)
      (bottom_color 1 1 1 0.2)
      (z-pos -317)
    )
    (gradient
      (top_color 1 1 1 0.1)
      (bottom_color 1 1 1 0.1)
      (z-pos 299)
    )
    (lantern
      (z-pos 50)
      (color 0 0 0)
      (x 512)
      (y 864)
    )
    (music
      (file "/music/boss/boss_battle_6.music")
    )
    (particles-ghosts
    )
    (particles-rain
      (z-pos 300)
      (intensity 2)
    )
    (root_sapling
      (z-pos -321)
      (x 800)
      (y 640)
    )
    (spawnpoint
      (name "main")
      (x 64)
      (y 832)
    )
    (thunderstorm
    )
    (tilemap
      (solid #f)
      (z-pos -100)
      (width 35)
      (height 35)
      (tiles -1225 0)
    )
    (tilemap
      (solid #f)
      (z-pos 100)
      (width 35)
      (height 35)
      (tiles -1225 0)
    )
    (tilemap
      (solid #t)
      (z-pos 0)
      (width 35)
      (height 35)
      (tiles -945 0 -2 1425 1424 1425 1424 -4 1425 1424 1425 1424 -2 1425 1424 -2 1425 1424 1425 -2 1424 1425 -2 1424 1425 -2 1424 1425 -5 1424 -2 1425 -3 1429 -4 1428 1429 1428 -2 1429 -3 1428 -3 1429 -2 1428 1429 -6 1428 1429 1428 1429 1428 1429 -4 1428 1436 1433 1437 1432 -2 1437 1433 -2 1437 -5 1432 -4 1437 1432 1433 1437 -4 1432 -3 1436 1437 -2 1436 -2 1432 1436 1432 1436 1432 1433 1432 1437 1436 -4 1437 -2 1436 1432 1437 1436 1433 1432 -2 1437 1432 1433 1437 1433 1432 1433 1436 1433 1432 1436 -2 1432 -2 1436 1437 1436 -3 1437 1436 1437 -3 1432 1437 1436 1432 1437 1432 1437 1433 1437 1436 -4 1432 1436 1437 -2 1436 1437 1436 1432 1436 -2 1432 1436 1432 1436 1432 -2 1437 1433 -3 1437 1436 1433 1437 1436 1437 1432 1436 1437 1432 1436 1432 1436 -4 1432 1436 -3 1432 1437 -2 1436 -2 1432 1436 1432 1436 1432 1437 1436 1437 1432 1437 1436 1432 1437 1432 1433 -2 1436 -2 1437 1432 1433 1436 1432 1436 1433 -2 1432 1436 1432 -2 1437 1432 1437 1432 1436 1433 -3 1436 1433 1432 1433 1436 1433 1437 1436 1437 -9 1432 1436 1437 1432 -2 1436 1433 1436 1437 -2 1436 1437 -2 1436 1432 1437 1432 1437 1432 1437)
    )
    (tilemap
      (solid #t)
      (z-pos -1)
      (width 35)
      (height 35)
      (tiles -1225 0)
    )
    (tilemap
      (solid #f)
      (tint 0.5 0.5 0.5)
      (z-pos -50)
      (width 35)
      (height 35)
      (tiles -1225 0)
    )
    (tilemap
      (solid #t)
      (z-pos -7)
      (name "a")
      (width 35)
      (height 35)
      (tiles -1225 0)
    )
    (tilemap
      (solid #f)
      (z-pos -102)
      (width 35)
      (height 35)
      (tiles -1225 0)
    )
    (tilemap
      (solid #f)
      (z-pos -101)
      (width 35)
      (height 35)
      (tiles -1225 0)
    )
  )
)
