(supertux-level
  (version 3)
  (name (_ "scrapped zone"))
  (author "Sophie Ball")
  (note (_ "Scrapped Brain Zone :3"))
  (license "CC-BY-SA 4.0 International")
  (allow-item-pocket "inherit")
  (icon "")
  (icon-locked "")
  (statistics
    (enable-coins #t)
    (enable-badguys #f)
    (enable-secrets #t)
  )
  (sector
    (name "main")
    (ambient-light
      (color 1 1 1)
    )
    (background
      (color 1 1 1)
      (speed 0)
      (image "/images/background/misc/skybox_stars.png")
    )
    (camera
      (name "Camera")
      (mode "normal")
    )
    (corrupted_granito_big
      (z-pos 47)
      (x 2360)
      (y 784)
    )
    (darttrap
      (z-pos -1)
      (initial-delay 0)
      (fire-delay 2)
      (ammo -1)
      (direction "right")
      (x 1472)
      (y 736)
    )
    (darttrap
      (z-pos -1)
      (initial-delay 0)
      (fire-delay 2)
      (ammo -1)
      (direction "right")
      (x 2048)
      (y 736)
    )
    (darttrap
      (z-pos -1)
      (initial-delay 0)
      (fire-delay 2)
      (ammo -1)
      (direction "down")
      (x 2464)
      (y 416)
    )
    (darttrap
      (z-pos -1)
      (initial-delay 0)
      (fire-delay 2)
      (ammo -1)
      (direction "down")
      (x 2656)
      (y 416)
    )
    (darttrap
      (z-pos -1)
      (initial-delay 0)
      (fire-delay 2)
      (ammo -1)
      (direction "down")
      (x 2848)
      (y 416)
    )
    (darttrap
      (z-pos -1)
      (initial-delay 0)
      (fire-delay 2)
      (ammo -1)
      (x 2240)
      (y 224)
    )
    (music
      (file "/music/bad_future/forest_fantasy.music")
    )
    (spawnpoint
      (name "main")
      (x 32)
      (y 832)
    )
    (tilemap
      (solid #f)
      (z-pos -100)
      (width 100)
      (height 35)
      (tiles -3500 0)
    )
    (tilemap
      (solid #f)
      (z-pos 100)
      (width 100)
      (height 35)
      (tiles -3500 0)
    )
    (tilemap
      (solid #t)
      (z-pos 0)
      (width 100)
      (height 35)
      (tiles -2483 0 6271 6272 1424 1425 1424 1425 -3 1424 1425 1426 -23 0 6271 6272 -2 1425 6273 6274 -8 0 6271 6272 1425 1424 1425 -2 1424 -2 1425 -2 1424 -3 1425 -2 1424 1425 -5 1424 1425 1424 -4 1425 -2 1424 1425 1424 -4 1425 1424 1425 -3 1424 -2 1425 1424 1425 -2 1424 1425 1424 1425 6281 6282 6275 6276 -2 1429 -4 1428 -2 1429 1430 -19 0 6271 6272 6281 6282 6275 6276 1429 1428 6277 6278 6706 -6 0 6705 6275 6276 -5 1429 -2 1428 1429 1428 -3 1429 1428 -3 1429 -2 1428 1429 -2 1428 -2 1429 -2 1428 -2 1429 1428 -2 1429 -3 1428 1429 1428 -2 1429 -2 1428 -2 1429 1428 -2 1429 -3 1428 1429 6285 6286 1450 1432 -2 1437 1432 1437 1436 1437 -2 1432 1434 -6 0 1425 1424 -3 1425 -3 1424 -2 1425 1424 6281 6282 6275 6276 6285 6286 1450 -2 1432 1437 1432 1451 6710 -6 0 6709 1450 1432 1436 1432 1436 1432 1437 1436 -3 1432 1436 1437 1436 1433 1436 -3 1437 -2 1432 1433 -2 1432 -2 1437 -3 1436 1437 1436 1432 -2 1436 1432 -3 1436 1433 1437 1433 1436 -5 1437 -3 1432 1436 1437 1432 1437 -2 1436 1437 1433 -2 1432 1436 1432 1434 -6 0 1429 -3 1428 -3 1429 1428 1429 1428 1429 6285 6286 1450 -2 1432 1437 -2 1432 1436 -2 1437 1433 3413 -6 0 3412 -5 1437 -2 1432 1433 1436 1432 -4 1436 1432 -2 1437 1432 -2 1437 1433 1432 1436 1432 1436 1432 1436 1433 -2 1437 1436 1437 1436 1433 1436 1437 1436 1433 1437 1432 1433 1436 1433 -2 1432 -2 1437 -4 1436 1437 1432 1436 -3 1432 1436 -2 1432 1436 1432 1434 -6 0 -3 1436 1432 -2 1436 1432 -2 1437 1433 1432 -2 1436 -2 1437 1433 1436 1432 -2 1433 1437 1432 3414 3418 -6 0 3416 3415 1432 1436 1432 1436 1432 1437 1436 1433 1432 1436 1437 -3 1432 1433 -2 1437 1432 -2 1437 1436 1433 1437 1436 1432 1437 -2 1436 1432 -2 1436 1432 1436 1437 1436 1432 1436 -4 1437 1436 1432 1437 1436 1432 1437 1436 1433 1432 1433 1436 1437 1436 -2 1432 1436 1432 1437 1432 1437 1438 -6 0 -2 1437 1432 -2 1437 1432 -2 1436 -2 1437 1432 -2 1437 1436 -2 1437 -2 1432 1437 -2 1432 1437 3413 -8 0 3412 -5 1436 -2 1437 1433 1437 -3 1436 1437 1436 1433 1436 1432 1437 1432 1437 1432 -2 1436 -2 1432 1437 1432 1437 -2 1432 1437 1433 1436 1433 1437 1432 -2 1436 1433 1432 1436 1432 1437 1432 1436 1432 1436 1432 1437 -3 1436 1437 1433 -2 1437 1432 1436 1433 1436 1432 1434 -6 0 1437 1432 1437 1436 1437 1433 1432 1436 1432 1433 -2 1437 -2 1436 1432 1433 1432 -2 1436 1432 1436 3414 3418 -8 0 3416 3415 1437 1432 1437 1433 -2 1437 1436 -2 1437 1433 1432 1437 1432 -3 1436 1432 1437 1433 -2 1432 1437 1432 1437 -2 1432 -3 1436 -3 1437 1433 -3 1437 1436 1432 1437 1432 1436 1437 1432 1436 1437 1432 1436 1432 -4 1436 1437 1436 1432 1433 1437 -2 1436 1432 1434 -6 0 1437 1436 1433 1436 -3 1437 -2 1436 -2 1437 -2 1432 -2 1436 1437 1432 1437 1432 1433 3414 3411 -10 0 3410 3415 -2 1432 1433 1436 1437 1432 1437 -2 1436 1437 1436 -2 1432 1437 -2 1436 -2 1432 1436 1433 1437 1436 -2 1432 1436 1437 1436 -3 1432 1436 1437 1432 1437 1436 1432 1436 1437 1432 1433 -2 1436 -2 1437 1432 1436 1437 1433 -3 1437 1432 1436 -2 1433 1437 -2 1436 1437 1438 -6 0 1432 -2 1437 1433 -2 1432 1437 1436 1437 1436 1437 1436 1437 1436 -2 1437 1432 1436 1432 1436 3413 -12 0 3412 1436 1437 1436 1433 -2 1432 1433 1437 1433 -2 1432 1436 -2 1433 1437 -2 1436 -2 1433 -2 1437 -2 1436 1432 -2 1436 1437 -2 1432 1436 1437 1432 1437 1436 1432 -2 1436 -9 1437 1432 1436 1432 -3 1437 1433 -2 1432 1433 -2 1432 1436 1434 -6 0 -2 1432 1436 1432 1433 1437 -2 1436 -2 1433 -2 1437 -2 1436 1433 -2 1436 -3 1432 3418 -12 0 3416 1437 -2 1432 1436 1437 1436 -3 1432 1437 1436 1433 1437 -2 1433 1437 1436 1437 1436 1437 1436 1437 1436 -2 1437 1436 -2 1437 1433 -2 1437 1436 1432 1437 -5 1432 1437 -2 1436 -5 1432 1436 1437 -3 1436 1437 -3 1436 -2 1432 1436 1438 -6 0)
    )
    (tilemap
      (solid #t)
      (z-pos -2)
      (width 100)
      (height 35)
      (tiles -1054 0 6699 6700 -14 0 6699 6700 -82 0 6701 6702 -14 0 6701 6702 -82 0 6701 6702 -14 0 6701 6702 -82 0 6701 6702 -14 0 6701 6702 -66 0 77 102 83 77 -12 0 6701 6702 -5 0 6699 6700 6699 6700 -5 0 6701 6702 -82 0 6701 6702 -5 0 6701 6702 6701 6702 -5 0 6701 6702 -82 0 6701 6702 -5 0 6701 6702 6701 6702 -5 0 6701 6702 -82 0 6701 6702 -5 0 6701 6702 6701 6702 -5 0 6701 6702 -64 0 77 83 77 -2 0 77 83 77 -10 0 6703 6704 -5 0 6701 6702 6701 6702 -5 0 6703 6704 -89 0 6701 6702 6701 6702 -96 0 6701 6702 6701 6702 -96 0 6701 6702 6701 6702 -69 0 6667 6668 6619 6620 6619 6620 6619 6620 6619 6620 6669 6670 -15 0 6703 6704 6703 6704 -69 0 6675 6676 6627 6628 6627 6628 6627 6628 6627 6628 6677 6678 -88 0 6637 6638 -8 0 6637 6638 -88 0 6645 6646 -8 0 6645 6646 -376 0 6619 6620 6619 6620 6619 6620 6619 6620 6619 6620 -90 0 6627 6628 6627 6628 6627 6628 6627 6628 6627 6628 -468 0)
    )
    (tilemap
      (solid #t)
      (z-pos -1)
      (width 100)
      (height 35)
      (tiles -353 0 6667 6668 6619 6620 6619 6620 6619 6620 6619 6620 6619 6620 6619 6620 6619 6620 6619 6620 6669 6670 -80 0 6675 6676 6627 6628 6627 6628 6627 6628 6627 6628 6627 6628 6627 6628 6627 6628 6627 6628 6677 6678 -80 0 6637 6638 -16 0 6637 6638 -80 0 6645 6646 -16 0 6645 6646 -80 0 6637 6638 -16 0 6637 6638 -80 0 6645 6646 -16 0 6645 6646 -80 0 6637 6638 -16 0 6637 6638 -80 0 6645 6646 -7 0 6655 6656 -7 0 6645 6646 -80 0 6637 6638 -7 0 6663 6664 -7 0 6637 6622 6619 6620 6619 6620 6619 6620 6619 6620 6619 6620 6619 6620 6619 6620 6619 6620 6619 6620 6623 6624 6625 6626 -58 0 6645 6646 -7 0 6671 6672 -7 0 6645 6630 6627 6628 6627 6628 6627 6628 6627 6628 6627 6628 6627 6628 6627 6628 6627 6628 6627 6628 6631 6632 6633 6634 -58 0 6637 6638 -7 0 6679 6680 -7 0 6637 6638 -80 0 6645 6646 -7 0 6637 6638 -7 0 6645 6646 -80 0 6637 6638 -7 0 6645 6646 -7 0 6637 6638 -80 0 6645 6646 -7 0 6637 6638 -7 0 6645 6646 -80 0 6637 6638 -7 0 6645 6646 -7 0 6637 6638 -80 0 6645 6646 -7 0 6637 6638 -7 0 6645 6646 -80 0 6657 6658 -7 0 6645 6646 -7 0 6637 6638 -80 0 6665 6666 -7 0 6637 6638 -7 0 6645 6646 -80 0 6673 6674 -7 0 6645 6646 -89 0 6681 6682 -7 0 6637 6638 -98 0 6645 6646 -98 0 6637 6638 -98 0 6645 6646 -259 0 -8 6654 -92 0 -8 6662 -569 0)
    )
    (tilemap
      (solid #f)
      (tint 0.5 0.5 0.5)
      (z-pos -50)
      (width 100)
      (height 35)
      (tiles -2171 0 6637 6638 -98 0 6645 6646 -98 0 6637 6638 -98 0 6645 6646 -98 0 6637 6638 -927 0)
    )
    (viciousivy
      (type "corrupted")
      (z-pos 50)
      (x 672)
      (y 800)
    )
  )
)
