(supertux-level
  (version 3)
  (name (_ "Forest Fantasy Round"))
  (author "Sophie Ball")
  (license "CC-BY-SA 4.0 International")
  (allow-item-pocket "on")
  (icon "")
  (icon-locked "")
  (sector
    (name "main")
    (ambient-light
      (color 0.9568627 0.6745098 1)
    )
    (background
      (color 0.5 0.0039215 0.9 0.4)
      (scroll-speed-x -50)
      (speed 0.5)
      (image "/images/background/misc/fog.png")
      (z-pos 300)
    )
    (level
      (z-pos 50)
      (x 25)
      (y 24)
    )
    (level
      (z-pos 50)
      (x 31)
      (y 25)
    )
    (level
      (z-pos 50)
      (x 28)
      (y 25)
    )
    (music
      (file "/music/worldmap/truefear.music")
    )
    (teleporter
      (z-pos 50)
      (worldmap "/levels/round5/worldmap.stwm")
      (sector "main")
      (spawnpoint "main")
      (message (_ "Go to Volcanic Vacation Round again?"))
      (x 21)
      (y 18)
    )
    (teleporter
      (z-pos 50)
      (worldmap "/levels/world1/worldmap.stwm")
      (sector "main")
      (spawnpoint "main")
      (message (_ "Go back to Icy Island Round?"))
      (x 33)
      (y 25)
    )
    (tilemap
      (solid #f)
      (tint 0.627451 0.254902 1)
      (z-pos -100)
      (width 100)
      (height 100)
      (tiles -10000 1)
    )
    (tilemap
      (solid #t)
      (z-pos 0)
      (width 100)
      (height 100)
      (tiles -1311 0 300 -4 301 302 -91 0 300 -2 301 309 -4 304 310 -9 301 302 -79 0 300 301 309 -17 304 310 302 -77 0 300 309 -20 304 310 302 -76 0 303 -22 304 310 301 302 -73 0 300 309 -24 304 310 302 -71 0 300 309 -26 304 305 -71 0 303 -27 304 310 302 -70 0 303 -28 304 310 302 -69 0 303 -29 304 305 -69 0 306 311 -28 304 310 302 -69 0 306 -5 307 311 -23 304 305 -75 0 306 311 -22 304 305 -76 0 306 307 311 -20 304 305 -78 0 306 -3 307 311 -16 304 305 -82 0 306 -2 307 311 -13 304 305 -85 0 306 -2 307 311 -10 304 305 -88 0 306 -10 307 308 -6965 0)
    )
    (tilemap
      (solid #f)
      (z-pos 4)
      (width 100)
      (height 100)
      (tiles -1418 0 343 344 343 344 343 344 350 351 -82 0 343 344 -2 0 343 344 -4 0 346 347 346 347 346 347 352 353 343 344 -80 0 346 347 350 351 346 347 -2 0 350 351 348 349 348 349 348 349 354 355 346 347 -78 0 350 351 348 349 352 353 348 349 -2 0 352 353 -8 0 348 349 -76 0 343 344 352 353 -2 0 354 355 -4 0 354 355 -86 0 346 347 354 355 -5 0 827 356 -3 0 548 550 821 -83 0 348 349 -6 0 548 550 0 548 -2 549 550 826 822 -86 0 827 826 -9 0 552 832 -95 0 820 817 818 -98 0 820 819 -2 0 552 -7679 0)
    )
    (tilemap
      (solid #f)
      (z-pos 5)
      (width 100)
      (height 100)
      (tiles -1613 0 343 344 -10 0 350 351 -82 0 343 344 350 351 346 347 350 351 343 344 -5 0 797 352 353 343 344 -78 0 350 351 346 347 352 353 348 349 352 353 346 347 -6 0 354 355 346 347 -76 0 343 344 352 353 348 349 354 355 343 344 354 355 348 349 -3 0 343 344 -3 0 348 349 350 351 -74 0 346 347 354 355 557 -2 0 557 346 347 557 0 557 -4 0 346 347 -5 0 352 353 -74 0 348 349 -2 0 558 -2 0 558 348 349 558 0 558 -4 0 348 349 -5 0 354 355 343 344 -94 0 343 344 -2 0 346 347 -94 0 346 347 -2 0 348 349 -94 0 348 349 -7571 0)
    )
    (tilemap
      (solid #f)
      (z-pos 3)
      (width 100)
      (height 100)
      (tiles -1313 0 343 344 -4 0 343 344 343 344 350 351 343 344 -80 0 350 351 0 829 831 0 346 347 -4 0 346 347 346 347 352 353 346 347 -80 0 352 353 0 830 832 0 348 349 350 351 343 344 348 349 348 349 354 355 348 349 -78 0 343 344 354 355 0 820 -4 0 352 353 346 347 -9 0 350 351 -75 0 346 347 -8 0 354 355 348 349 -9 0 352 353 -75 0 348 349 548 549 550 -18 0 354 355 343 344 -98 0 346 347 -98 0 348 349 350 351 -98 0 352 353 -98 0 354 355 -7766 0)
    )
    (tilemap
      (solid #f)
      (z-pos 2)
      (width 100)
      (height 100)
      (tiles -1212 0 350 351 343 344 -92 0 350 351 -2 0 352 353 346 347 0 350 351 -87 0 343 344 352 353 -2 0 354 355 348 349 0 352 353 -87 0 346 347 354 355 -7 0 354 355 -87 0 348 349 -9 0 349 -891 0 552 -7490 0)
    )
    (tilemap
      (solid #f)
      (z-pos 1)
      (width 100)
      (height 100)
      (tiles -1416 0 350 351 -98 0 352 353 -98 0 354 355 -89 0 543 -215 0 552 -100 0 356 -79 0 825 -5 0 828 356 -12 0 828 -2 0 825 -92 0 543 0 552 -81 0 548 549 550 -2 0 552 -19 0 552 -2 0 817 818 -77 0 542 -20 0 820 819 -78 0 825 -419 0 832 825 -7066 0)
    )
    (tilemap
      (solid #f)
      (z-pos 6)
      (width 100)
      (height 100)
      (tiles -1724 0 350 351 -84 0 343 344 -12 0 352 353 343 344 -82 0 346 347 -12 0 354 355 346 347 -82 0 348 349 -14 0 348 349 350 351 -88 0 343 344 -8 0 352 353 -88 0 346 347 -8 0 354 355 343 344 -86 0 348 349 -10 0 346 347 -98 0 348 349 -7568 0)
    )
    (tilemap
      (solid #t)
      (z-pos 7)
      (width 100)
      (height 100)
      (tiles -119 0 300 -3 301 302 -95 0 303 -3 304 305 -95 0 303 -3 304 305 -95 0 303 -3 304 305 -95 0 313 -3 314 315 -95 0 316 -3 317 318 -95 0 316 -3 317 318 -95 0 316 -3 317 318 -95 0 316 -3 317 318 -95 0 316 -3 317 318 -95 0 316 -3 317 318 -95 0 316 -3 317 318 -95 0 316 -3 317 318 -95 0 316 -3 317 318 -95 0 316 -3 317 318 -95 0 316 334 335 336 318 -95 0 319 337 338 339 321 -97 0 19 -99 0 21 -99 0 21 -99 0 21 -82 0 18 -9 20 11 -6 0 21 -92 0 21 -6 0 34 11 -91 0 14 -6 20 0 14 -3 20 11 -99 0 14 -6 20 23 -7466 0)
    )
    (tilemap
      (solid #f)
      (z-pos 100)
      (width 100)
      (height 100)
      (tiles -2107 0 343 344 -98 0 346 347 0 -2 557 350 351 -93 0 348 349 0 -2 558 352 353 343 344 -5 0 350 351 -89 0 354 355 346 347 -2 0 343 344 557 352 353 0 343 344 -88 0 348 349 -2 0 346 347 558 354 355 0 346 347 350 351 817 818 -88 0 348 349 -4 0 348 349 352 353 0 819 -96 0 354 355 -7272 0)
    )
    (tilemap
      (solid #f)
      (z-pos 101)
      (width 100)
      (height 100)
      (tiles -2413 0 343 344 350 351 -3 0 350 351 343 344 -89 0 346 347 352 353 343 344 0 352 353 346 347 -7 0 350 351 -80 0 348 349 354 355 346 347 0 354 355 348 349 -7 0 352 353 -84 0 348 349 -12 0 354 355 -7267 0)
    )
    (tilemap
      (solid #f)
      (z-pos 102)
      (width 100)
      (height 100)
      (tiles -2519 0 343 344 350 351 343 344 -94 0 346 347 352 353 346 347 350 351 343 344 350 351 0 343 344 -85 0 348 349 354 355 348 349 352 353 346 347 352 353 0 346 347 -91 0 354 355 348 349 354 355 0 348 349 -7166 0)
    )
    (tilemap
      (solid #f)
      (z-pos 103)
      (width 100)
      (height 100)
      (tiles -2620 0 343 344 350 351 -96 0 346 347 352 353 343 344 350 351 343 344 350 351 -88 0 348 349 354 355 346 347 352 353 346 347 352 353 -92 0 348 349 354 355 348 349 354 355 -7068 0)
    )
    (tilemap
      (solid #f)
      (z-pos 8)
      (width 100)
      (height 100)
      (tiles -220 0 219 220 221 -97 0 222 689 224 -97 0 225 226 227 -1296 0 -2 557 0 -2 557 -95 0 -2 558 0 -2 558 -497 0 12 -99 0 15 -7578 0)
    )
    (worldmap-spawnpoint
      (z-pos 50)
      (name "main")
      (x 32)
      (y 25)
    )
    (worldmap-spawnpoint
      (z-pos 50)
      (name "back")
      (x 21)
      (y 19)
    )
  )
  (tileset "images/ice_world.strf")
)
