(supertux-level
  (version 3)
  (name (_ "Menu Level"))
  (author "Sophie Ball")
  (license "CC-BY-SA 4.0 International")
  (allow-item-pocket "inherit")
  (icon "")
  (icon-locked "")
  (statistics
    (enable-coins #f)
    (enable-badguys #f)
    (enable-secrets #f)
  )
  (sector
    (name "main")
    (ambient-light
      (color 1 1 1)
    )
    (background
      (name "parallax2")
      (color 1 1 1)
      (alignment "bottom")
      (speed 0)
      (image "/images/background/antarctic/snow_panorama.png")
      (z-pos -250)
    )
    (background
      (name "skybox")
      (color 1 1 1)
      (alignment "top")
      (scroll-speed-x -10)
      (speed 0)
      (image "/images/background/misc/skybox.png")
      (z-pos -280)
    )
    (background
      (name "parallax1")
      (scroll-offset-y 120)
      (color 1 1 1)
      (speed 0.4)
      (image-top "/images/background/misc/transparent_up.png")
      (image "/images/background/antarctic/snowy_trees.png")
      (image-bottom "/images/background/antarctic/snow_bottom.png")
      (z-pos -200)
    )
    (background
      (color 1 1 1)
      (scroll-speed-x -5)
      (speed 0)
      (image "/images/background/misc/clouds.png")
      (z-pos -299)
    )
    (background
      (color 1 1 1 0.4)
      (scroll-speed-x -50)
      (speed 0.5)
      (image "/images/background/misc/fog.png")
      (z-pos 300)
    )
    (camera
      (name "Camera")
      (mode "normal")
    )
    (gradient
      (name "background")
      (top_color 0.3 0.4 0.75)
      (bottom_color 1 1 1)
    )
    (invisible_wall
      (width 320)
      (height 32)
      (x 18240)
      (y 1408)
    )
    (music
      (file "/music/misc/theme.music")
    )
    (particles-snow
      (name "snow_particles")
    )
    (rock
      (type "large")
      (z-pos 50)
      (x 96)
      (y 608)
    )
    (scripttrigger
      (oneshot #t)
      (script "Tux.deactivate();")
      (button #f)
      (width 32)
      (height 32)
      (x 640)
      (y 640)
    )
    (spawnpoint
      (name "main")
      (x 640)
      (y 608)
    )
    (tilemap
      (solid #f)
      (z-pos -100)
      (width 40)
      (height 30)
      (tiles -694 0 1321 1322 1323 1324 -36 0 1325 1326 1327 1328 -27 0 4145 4146 4147 4148 -5 0 1329 1330 1331 1332 -11 0 4137 4138 4139 4140 -6 0 24 -5 0 4149 4150 4151 4152 24 0 2623 2624 0 1333 1334 1335 1336 0 24 -4 0 2625 2626 0 5203 5204 4141 4142 4143 4144 0 5203 5204 -364 0)
    )
    (tilemap
      (solid #t)
      (z-pos 0)
      (width 40)
      (height 30)
      (tiles -1200 0)
    )
    (tilemap
      (solid #f)
      (z-pos 100)
      (width 40)
      (height 30)
      (tiles -960 0 -3 5539 5540 -17 0 5538 -5 5539 5540 -10 0 5538 5539 -3 5543 5547 -3 5539 5540 -8 0 5538 -4 5539 5548 5549 -2 5545 5549 5545 5547 -4 5539 5540 -2 0 5538 -2 5539 5548 -3 5543 5545 -3 5549 5543 5547 -8 5539 5548 5543 5549 5543 -3 5545 5549 -3 5545 5549 5543 5549 -2 5545 5547 -2 5539 5548 5543 -2 5549 5545 5543 5549 -2 5543 5549 5545 5549 5545 5549 5543 -2 5549 5545 5549 5545 5549 -2 5545 5549 5545 5549 5543 -2 5549 5543 5549 5545 5543 -2 5545 5549 5543 5545 5543 5545 5543 5545 5549 5543 5545 5543 -3 5545 5549 -2 5543 -3 5549 5543 5549 5545 5543 5549 5545 5549 -2 5545 5543 -2 5549 5543 -3 5549 5543 5545 5543 -3 5549 -2 5545 -2 5549 -2 5545 -2 5543 5549 -2 5543 5545 -2 5549 5545 -2 5549 5543 5545 5549 5543 -2 5549 -2 5543 5545 -2 5543 5549 -3 5545 5543 5549 -2 5545 5549 5543 5545 5549 5545 5549 5545 5543 5545 5549 -2 5543)
    )
    (tilemap
      (solid #f)
      (alpha 0)
      (z-pos 10)
      (name "christmas")
      (width 40)
      (height 30)
      (tiles -1200 0)
    )
    (tilemap
      (solid #f)
      (z-pos -110)
      (width 40)
      (height 30)
      (tiles -1200 0)
    )
    (tilemap
      (solid #t)
      (z-pos -50)
      (width 40)
      (height 30)
      (tiles -528 0 83 -22 0 83 -134 0 78 83 78 83 78 -18 0 78 83 78 83 78 -46 0 2913 2914 -36 0 2909 2910 2915 2916 2917 2918 -32 8 2921 2922 2911 2912 11 1835 2919 2920 14 3990 -18 14 3990 -2 14 3989 -5 14 3990 -2 14 2923 2924 1834 -2 11 5369 -3 11 5368 -2 11 5368 -2 11 -2 5368 5369 5368 11 5369 -2 11 5368 5369 5368 -3 11 5368 5369 -2 11 5368 11 5369 -2 11 5369 -3 11 5368 -3 11 -2 5369 11 -2 5368 5369 -5 11 5369 11 -2 5368 11 5368 11 5369 11 5369 11 5368 -2 11 5368 -4 11 5369 5368 -2 11 5368 -2 11 5369 -3 11 5368 11 -2 5369 -3 11 5369 5368 -4 11 -2 5368 -3 11 5368 5369 5368 11 -3 5368 11 5369 11 5368 5369 -4 11 5368 5369 11 -2 5368 5369 -11 11 5369 11 5369 -2 11 -2 5368 -4 11 5369 11 5368 -2 5369 5368 -2 11 5368 11 5369 -2 11 5369 -2 5368 5369 -2 11 5369 11 -2 5368 5369 -2 5368 -2 11 -2 5368 -2 11 5368 11 5369 -8 11 5368 -3 11 -4 5368 -2 5369 -2 11 5369 11 5369 5368 5369 -3 11 -2 5369 -11 11 5368 -2 5369 5368 -2 11 1539 -3 11 5368 11 5369 11 5369 -2 11 5368 11 5369 -3 11 5369 -2 5368 11 5369 11 -2 5369 11 5368 -5 11 5369 -2 11 5368 -3 11 5368 11 5368 5369 -8 11 5368 -4 5369 11 -2 5369 -3 11 5368 11 -2 5369 -2 11 -2 5368 11 -2 5368 -4 11 5369 -4 11 5369 11 5369 11 5369 11 5369 -2 11 -2 5368)
    )
    (tilemap
      (solid #t)
      (z-pos -1)
      (width 40)
      (height 30)
      (tiles -1200 0)
    )
    (trampoline
      (z-pos 50)
      (x 1152)
      (y 640)
    )
  )
)
